!SIL sil
<UNK> spn
żal	Z a l
craig	c r a i g
no	n o
interpretacji	i n t e r p r e t a c j i
tysięcy	t i2 sj eo5 c i2
przywitaj	p S i2 v i t a j
oferty	o f e r t i2
dziale	dzj a l e
potykam	p o t i2 k a m
przerąbała	p S e r oc5 b a w a
talent	t a l e n t
później	p u zj n i e j
świętej	sj v i eo5 t e j
uobecniasz	u o b e c n i a S
płytkiej	p w i2 t k i e j
małgorzata	m a w g o Z a t a
czynu	tS i2 n u
która	k t u r a
uderzenie	u d e Z e n i e
spustoszył	s p u s t o S i2 w
sceniczna	s c e n i tS n a
warunkach	v a r u n k a h
graną	g r a n oc5
masło	m a s w o
czymś	tS i2 m sj
liturgicznego	l j t u r g i tS n e g o
toczyło	t o tS i2 w o
akompaniamencie	a k o m p a n i a m e n tsj e
fabryki	f a b r i2 k i
oknie	o k n i e
przesmyki	p S e s m i2 k i
poniósłszy	p o n i u s w S i2
budzić	b u dzj i tsj
chciałbym	h tsj a w b i2 m
drzemie	d Z e m i e
akcją	a k c j oc5
wyznacza	v i2 z n a tS a
patronatem	p a t r o n a t e m
próbowałem	p r u b o v a w e m
biodrami	b i o d r a m i
mycia	m i2 tsj a
kropki	k r o p k i
mamę	m a m e
kartezjuszu	k a r t e z j u S u
serio-	s e r j o
potraw	p o t r a v
przeciw	p S e tsj i v
anti	a n t j
wykształcona	v i2 k S t a w c o n a
puzonie	p u z o n i e
faktu	f a k t u
niesprawiedliwych	n i e s p r a v i e d l j v i2 h
wzywając	v z i2 v a j oc5 c
zanim	z a n i m
łut	w u t
przychodzą	p S i2 h o dz oc5
uproś	u p r o sj
autorskiego	a u t o r s k i e g o
miliona	m i l j o n a
środków	sj r o t k u v
uczyni	u tS i2 n i
spiskowiec	s p i s k o v i e c
piwie	p i v i e
chcąc	h c oc5 c
wzruszyłam	v z r u S i2 w a m
nobla	n o b l a
odpowiadać	o d p o v i a d a tsj
raz	r a z
wyrażalne	v i2 r a Z a l n e
cieszącego	tsj e S oc5 c e g o
służbę	s w u Z b e
połączone	p o w oc5 tS o n e
wyrobionej	v i2 r o b i o n e j
której	k t u r e j
przeciętnej	p S e tsj eo5 t n e j
ważnym	v a Z n i2 m
sztuka	S t u k a
estée	e s t e
polskimi	p o l s k i m i
dłużej	d w u Z e j
atakowanego	a t a k o v a n e g o
i'm	i m
wypowiedzi	v i2 p o v i e dzj i
nieco	n i e c o
nad	n a d
ulubione	u l u b i o n e
podróżować	p o d r u Z o v a tsj
okrucieństwo	o k r u tsj e n~ s t f o
pewności	p e v n o sj tsj i
ubóstwa	u b u s t f a
młodej	m w o d e j
fałsz	f a w S
chciałabyś	h tsj a w a b i2 sj
noszone	n o S o n e
rzadziej	Z a dzj e j
www	v v v
freuda	f r e u d a
jukatan	j u k a t a n
powozem	p o v o z e m
oszczędności	o S tS eo5 d n o sj tsj i
prokuratorem	p r o k u r a t o r e m
zaimplementowane	z a i m p l e m e n t o v a n e
dolegliwości	d o l e g l j v o sj tsj i
wife's	v i f e s
godzinie	g o dzj i n i e
przyjaźń	p S i2 j a zj n~
naturalne	n a t u r a l n e
nogi	n o g i
tradycyjne	t r a d i2 c i2 j n e
sprawne	s p r a v n e
rolę	r o l e
dziewczyny	dzj e v tS i2 n i2
wśród	v sj r u d
schodzę	s h o dz e
saula	s a u l a
zniszczenie	z n i S tS e n i e
grobów	g r o b u v
legat	l e g a t
szerokość	S e r o k o sj tsj
wielkość	v i e l k o sj tsj
odporności	o d p o r n o sj tsj i
wzięto	v zj eo5 t o
wysyłali	v i2 s i2 w a l j
pierwszym	p i e r v S i2 m
największe	n a j v i eo5 k S e
tamtym	t a m t i2 m
filmowym	f i l m o v i2 m
użytkownik	u Z i2 t k o v n i k
więcej	v i eo5 c e j
wodna	v o d n a
instynktów	i n s t i2 n k t u v
przystaje	p S i2 s t a j e
urana	u r a n a
zakopać	z a k o p a tsj
that	t h a t
łyków	w i2 k u v
topniały	t o p n i a w i2
fotooferty	f o t o o f e r t i2
skórze	s k u Z e
ludzkości-	l u dz k o sj tsj i e
stały	s t a w i2
sadzenia	s a dz e n i a
sceny	s c e n i2
załamuje	z a w a m u j e
mocy	m o c i2
krwawnika	k r v a v n i k a
błyskawica	b w i2 s k a v i c a
przy	p S i2
zwierzątka	z v i e Z oc5 t k a
daj	d a j
komisy	k o m i s i2
bojowe	b o j o v e
wzrok	v z r o k
ekonomiczne	e k o n o m i tS n e
odkrywczy	o t k r i2 v tS i2
rozbrzmiewało	r o z b Z m i e v a w o
odwrotnie-	o d v r o t n i e e
udoskonalił	u d o s k o n a l j w
namacalna	n a m a c a l n a
tle	t l e
żoną	Z o n oc5
tłuściejsze	t w u sj tsj e j S e
does	d o e s
dobrodziejstwem	d o b r o dzj e j s t f e m
takiej	t a k i e j
dziewczyna	dzj e v tS i2 n a
księdza	k sj eo5 dz a
łza	w z a
zapowiedzi	z a p o v i e dzj i
programem-	p r o g r a m e m e
świnia	sj v i n i a
pobratymca	p o b r a t i2 m c a
większą	v i eo5 k S oc5
pasuje	p a s u j e
uśmiechnij	u sj m i e h n i j
domowego	d o m o v e g o
abstrakcyjną	a b s t r a k c i2 j n oc5
przepisywano	p S e p i s i2 v a n o
danych	d a n i2 h
także	t a g Z e
zapalonych	z a p a l o n i2 h
święcie	sj v i eo5 tsj e
wyjaśnić	v i2 j a sj n i tsj
orb	o r b
napisane	n a p i s a n e
pola	p o l a
edessy	e d e S i2
mógłby	m u g w b i2
mussoliniego	m u S o l j n i e g o
własnych	v w a s n i2 h
inni	i n n i
robić	r o b i tsj
bo	b o
strojach	s t r o j a h
pomorską	p o m o r s k oc5
mgnienie	m g n i e n i e
wykorzystywane	v i2 k o Z i2 s t i2 v a n e
nadzieją	n a dzj e j oc5
wykonaj	v i2 k o n a j
widziałem	v i dzj a w e m
kościelną	k o sj tsj e l n oc5
prześpię	p S e sj p i e
wielkiego	v i e l k i e g o
lektura	l e k t u r a
astronom	a s t r o n o m
zlicza	z l j tS a
książka	k tsj oc5 Z k a
podstawówce	p o d s t a v u v c e
wspaniałomyślność	v s p a n i a w o m i2 sj l n o sj tsj
połowy	p o w o v i2
dodatkową	d o d a t k o v oc5
nadać	n a d a tsj
sympatia	s i2 m p a t j a
niechęci	n i e h eo5 tsj i
konieczności	k o n i e tS n o sj tsj i
dramat	d r a m a t
księcia	k sj eo5 tsj a
klatkę	k l a t k e
niebios	n i e b i o s
jeżeli	j e Z e l j
piersi	p i e r sj i
jeden	j e d e n
ideologiczną	i d e o l o g i tS n oc5
kreona	k r e o n a
zmieścić	z m i e sj tsj i tsj
dożywocie	d o Z i2 v o tsj e
opowiada	o p o v i a d a
gołębia	g o w eo5 b i a
kółkach	k u w k a h
prezydent	p r e z i2 d e n t
manifestować	m a n i f e s t o v a tsj
łuk	w u k
błyskawice	b w i2 s k a v i c e
zakończenie	z a k o n~ tS e n i e
rzeź	Z e zj
unikam	u n i k a m
akcesoria	a k c e s o r j a
niezbędnym	n i e z b eo5 d n i2 m
słowa	s w o v a
wiódł	v i u d w
prawdy	p r a v d i2
prawie	p r a v i e
przekonaniu	p S e k o n a n i u
pokusy	p o k u s i2
przeświadczenie	p S e sj v i a d tS e n i e
zarabiać	z a r a b i a tsj
gestem	g e s t e m
komputerów	k o m p u t e r u v
perswazji	p e r s v a z j i
gędził	g eo5 dzj i w
czynszowe	tS i2 n S o v e
publicznym	p u b l j tS n i2 m
wyjdziesz	v i2 j dzj e S
dbali	d b a l j
rozdzielczości	r o z dzj e l tS o sj tsj i
zostali	z o s t a l j
wyprostuj	v i2 p r o s t u j
refleksji	r e f l e k s j i
życiem	Z i2 tsj e m
bytu	b i2 t u
wziął	v zj oc5 w
reagowałeś	r e a g o v a w e sj
kwantowymi	k f a n t o v i2 m i
aforyzmy	a f o r i2 z m i2
niespodzianej	n i e s p o dzj a n e j
zakochanych	z a k o h a n i2 h
twoja	t f o j a
wiersza	v i e r S a
ujarzmienie	u j a Z m i e n i e
ułatwieniem	u w a t f i e n i e m
bestię	b e s t j e
startowałaś	s t a r t o v a w a sj
zamierzonego	z a m i e Z o n e g o
oceniona	o c e n i o n a
łez	w e z
razie	r a zj e
źródło	zj r u d w o
uwagę	u v a g e
mikrokosmosu	m i k r o k o s m o s u
piątym	p i oc5 t i2 m
kierownictwo	k i e r o v n i c t f o
górną	g u r n oc5
jednym	j e d n i2 m
przedstawimy	p S e d s t a v i m i2
spróbuję	s p r u b u j e
sojuszników	s o j u S n i k u v
redakcyjny	r e d a k c i2 j n i2
wiarę	v i a r e
zadowoliłaby	z a d o v o l j w a b i2
seks-maniaka	s e k s m a n i a k a
grałam	g r a w a m
gęsi	g eo5 sj i
quentin	k e n t j n
mojej	m o j e j
owego	o v e g o
krwawię	k r v a v i e
rozczarowaniem	r o z tS a r o v a n i e m
większe	v i eo5 k S e
mocnej	m o c n e j
skruchę	s k r u h e
wyciągnął	v i2 tsj oc5 g n oc5 w
wiadomo	v i a d o m o
rozprowadziła	r o z p r o v a dzj i w a
shoping	s h o p i n g
kąpieli	k oc5 p i e l j
jutro	j u t r o
argumenty	a r g u m e n t i2
atrybutami	a t r i2 b u t a m i
pełni	p e w n i
zdradzisz	z d r a dzj i S
zdradzić	z d r a dzj i tsj
komie	k o m i e
przede	p S e d e
ciemniejszych	tsj e m n i e j S i2 h
prośby	p r o sj b i2
przebaczającym	p S e b a tS a j oc5 c i2 m
ekranie	e k r a n i e
duże	d u Z e
policzki	p o l j tS k i
pytać	p i2 t a tsj
średni	sj r e d n i
chrochodylek	h r o h o d i2 l e k
subwoofer	s u b v o o f e r
wpływ	v p w i2 v
smartsuite	s m a r t s u i t e
też	t e S
ograł	o g r a w
zastosujemy	z a s t o s u j e m i2
niesmak	n i e s m a k
wakacje	v a k a c j e
towarzysząca	t o v a Z i2 S oc5 c a
polszczyzną	p o l S tS i2 z n oc5
microsoftu	m i c r o s o f t u
dokonany	d o k o n a n i2
spotkałam	s p o t k a w a m
przemawia	p S e m a v i a
szczątek	S tS oc5 t e k
realna	r e a l n a
dzieci	dzj e tsj i
dziewczynę	dzj e v tS i2 n e
bohra	b o h r a
zmienia	z m i e n i a
kremy	k r e m i2
historycznych	h j s t o r i2 tS n i2 h
pisanie	p i s a n i e
miecza	m i e tS a
rybacy	r i2 b a c i2
były	b i2 w i2
książki	k tsj oc5 Z k i
podejrzanego	p o d e j Z a n e g o
listu	l j s t u
najwięcej	n a j v i eo5 c e j
doświadczyłeś	d o sj v i a d tS i2 w e sj
np	n p
junacka	j u n a c k a
zanik	z a n i k
wyznań	v i2 z n a n~
koniec	k o n i e c
żółwia	Z u w v i a
żądny	Z oc5 d n i2
mego	m e g o
wojennych	v o j e n n i2 h
niezbędne	n i e z b eo5 d n e
biblioteką	b i b l j o t e k oc5
procedur	p r o c e d u r
hamburg	h a m b u r g
najnowszym	n a j n o v S i2 m
niepodzielne	n i e p o dzj e l n e
nauczaniem	n a u tS a n i e m
dokonywać	d o k o n i2 v a tsj
ludy	l u d i2
szary	S a r i2
raju	r a j u
różnorakie	r u Z n o r a k i e
są	s oc5
chodzić	h o dzj i tsj
metr	m e t r
pędzeni	p eo5 dz e n i
uścisk	u sj tsj i s k
przygotowuje	p S i2 g o t o v u j e
tajemnic	t a j e m n i c
rzucone	Z u c o n e
zagradza	z a g r a dz a
obejrzenia	o b e j Z e n i a
wyrazić	v i2 r a zj i tsj
stożkach	s t o Z k a h
rozpoczyna	r o z p o tS i2 n a
ejże	e j Z e
dziesiątym	dzj e tsj oc5 t i2 m
śpi	sj p i
początku	p o tS oc5 t k u
powinnaś	p o v i n n a sj
seryjni	s e r i2 j n i
morskiej	m o r s k i e j
osoba	o s o b a
rozprawy	r o z p r a v i2
przeszłość	p S e S w o sj tsj
skorzystać	s k o Z i2 s t a tsj
opiekować	o p i e k o v a tsj
filozofem	f i l o z o f e m
postrzegał	p o s t S e g a w
każe	k a Z e
dzieła	dzj e w a
przymusem	p S i2 m u s e m
koncert	k o n c e r t
szczerość	S tS e r o sj tsj
zeszłego	z e S w e g o
zadawałem	z a d a v a w e m
wami	v a m i
wzory	v z o r i2
wstążek	v s t oc5 Z e k
rodzą	r o dz oc5
przekroczy	p S e k r o tS i2
niekoniecznie	n i e k o n i e tS n i e
niezwyciężony	n i e z v i2 tsj eo5 Z o n i2
zainteresowań	z a i n t e r e s o v a n~
sakrament	s a k r a m e n t
wierzyć	v i e Z i2 tsj
odejść	o d e j sj tsj
zwątpili	z v oc5 t p i l j
delikatny	d e l j k a t n i2
dobry	d o b r i2
bunt	b u n t
pozorami	p o z o r a m i
widmo	v i d m o
niebawem	n i e b a v e m
samobójstwo	s a m o b u j s t f o
myśli	m i2 sj l j
realny	r e a l n i2
głównie	g w u v n i e
powodów	p o v o d u v
cokolwiek	c o k o l v i e k
wędrowca	v eo5 d r o v c a
pokolenia	p o k o l e n i a
celu	c e l u
wiec	v i e c
zastanawiałem	z a s t a n a v i a w e m
jasne	j a s n e
lewe	l e v e
użytkownicy	u Z i2 t k o v n i c i2
światło	sj v i a t w o
absurdalnych	a b s u r d a l n i2 h
zamknięciu	z a m k n i eo5 tsj u
dosłownie	d o s w o v n i e
przemyślnie	p S e m i2 sj l n i e
dociekania	d o tsj e k a n i a
patrzy	p a t S i2
ckosmo	c k o s m o
zakon	z a k o n
możliwość	m o Z l j v o sj tsj
atutów	a t u t u v
broni	b r o n i
postawi	p o s t a v i
zabrania	z a b r a n i a
nim	n i m
przykładzie	p S i2 k w a dzj e
niestrudzony	n i e s t r u dz o n i2
które	k t u r e
mieszkania	m i e S k a n i a
osiągnięte	o tsj oc5 g n i eo5 t e
inhalacji	i n h a l a c j i
potężniejszymi	p o t eo5 Z n i e j S i2 m i
systemowe	s i2 s t e m o v e
płciowym	p w tsj o v i2 m
usłyszeć	u s w i2 S e tsj
teraźniejszym	t e r a zj n i e j S i2 m
kobiecość	k o b i e c o sj tsj
momentu	m o m e n t u
pieniądze	p i e n i oc5 dz e
nieużytym	n i e u Z i2 t i2 m
cudach	c u d a h
szczególnych	S tS e g u l n i2 h
zleniwiały	z l e n i v i a w i2
zatrzymani	z a t S i2 m a n i
krzywego	k S i2 v e g o
gadacza	g a d a tS a
matek	m a t e k
wymówek	v i2 m u v e k
tożsamy	t o Z s a m i2
mistrzowie	m i s t S o v i e
wino	v i n o
rzeczywistości-	Z e tS i2 v i s t o sj tsj e
dostała	d o s t a w a
boku	b o k u
drgań	d r g a n~
praktyczne	p r a k t i2 tS n e
pieściłaś	p i e sj tsj i w a sj
mariesjew	m a r j e s j e v
tajnych	t a j n i2 h
rzeczywistość	Z e tS i2 v i s t o sj tsj
jakoby	j a k o b i2
całkiem	c a w k i e m
zdejmuj	z d e j m u j
postacie	p o s t a tsj e
położenia	p o w o Z e n i a
rozstrzygnąć	r o z s t S i2 g n oc5 tsj
przegranych	p S e g r a n i2 h
suwałk	s u v a w k
chętniej	h eo5 t n i e j
gończe	g o n~ tS e
jeszcze	j e S tS e
pirackich	p i r a c k i h
śmiercią	sj m i e r tsj i oc5
pospieszna	p o s p i e S n a
dużą	d u Z oc5
kafki	k a f k i
wolności	v o l n o sj tsj i
białe	b i a w e
pracę	p r a c e
francisco	f r a n tsj i s c o
manifesty	m a n i f e s t i2
umykało	u m i2 k a w o
poezja	p o e z j a
kupuję	k u p u j e
pracowicie	p r a c o v i tsj e
piętnastego	p i eo5 t n a s t e g o
pogardzie	p o g a r dzj e
ostatecznym	o s t a t e tS n i2 m
pomidorówki	p o m i d o r u v k i
świecie	sj v i e tsj e
zbiorowa	z b i o r o v a
ziemskim	zj e m s k i m
amerykańskie	a m e r i2 k a n~ s k i e
dziękuję	dzj eo5 k u j e
kilka	k i l k a
wyglądu	v i2 g l oc5 d u
metrów	m e t r u v
szła	S w a
2	d
poznaje	p o z n a j e
ogrodem	o g r o d e m
kobietę	k o b i e t e
jednostki	j e d n o s t k i
mnie	m n i e
minione	m i n i o n e
dochodzi	d o h o dzj i
protezy	p r o t e z i2
obiera	o b i e r a
otwory	o t f o r i2
powiekę	p o v i e k e
uwodzenia	u v o dz e n i a
pochłonięta	p o h w o n i eo5 t a
przychwycić	p S i2 h v i2 tsj i tsj
zasłanych	z a s w a n i2 h
działania	dzj a w a n i a
ziemianie	zj e m i a n i e
noc	n o c
jednolitej	j e d n o l j t e j
pantomimą	p a n t o m i m oc5
niech	n i e h
mówiłaś	m u v i w a sj
iż	i S
tytuły	t i2 t u w i2
zbuntowane	z b u n t o v a n e
spotykanej	s p o t i2 k a n e j
właśnie	v w a sj n i e
urzeczywistnia	u Z e tS i2 v i s t n i a
sytuacjom	s i2 t u a c j o m
wyruszy	v i2 r u S i2
b-17	b e o sj
stawiły	s t a v i w i2
spowodowane	s p o v o d o v a n e
panują	p a n u j oc5
bierze	b i e Z e
propozycje	p r o p o z i2 c j e
akceptację	a k c e p t a c j e
rozrywkach	r o z r i2 v k a h
każde	k a Z d e
ukochany	u k o h a n i2
kosiński	k o sj i n~ s k i
wprawdzie	v p r a v dzj e
wiecznym	v i e tS n i2 m
po	p o
chrześcijaństwo	h Z e sj tsj i j a n~ s t f o
lokomotywy	l o k o m o t i2 v i2
zaznajomienie	z a z n a j o m i e n i e
płaczącym	p w a tS oc5 c i2 m
wybijają	v i2 b i j a j oc5
dzieciom	dzj e tsj o m
brat	b r a t
lśniącymi	l sj n i oc5 c i2 m i
wskazywać	v s k a z i2 v a tsj
uważaliśmy	u v a Z a l j sj m i2
osiemdziesiątych	o sj e m dzj e tsj oc5 t i2 h
w	v
umie	u m i e
znużenia	z n u Z e n i a
leibnizu	l e i b n i z u
najlepiej	n a j l e p i e j
mawsu'at	m a v s u a t
żałobną	Z a w o b n oc5
krótkometrażowego	k r u t k o m e t r a Z o v e g o
więc	v i eo5 c
pomogło	p o m o g w o
zadaniem	z a d a n i e m
starożytnego	s t a r o Z i2 t n e g o
domatowa	d o m a t o v a
metafizyczny	m e t a f i z i2 tS n i2
store.britannica.com	s t o r e b r j t a n n i c a c o m
protestu	p r o t e s t u
nieoczekiwana	n i e o tS e k i v a n a
przejściowe	p S e j sj tsj o v e
przekroczyć	p S e k r o tS i2 tsj
straszliwe	s t r a S l j v e
ciekawej	tsj e k a v e j
staram	s t a r a m
777	sj e e
jakich	j a k i h
czai	tS a i
drobinkę	d r o b i n k e
chyba	h i2 b a
próbowałaś	p r u b o v a w a sj
własnego	v w a s n e g o
warstwie	v a r s t f i e
chciałby	h tsj a w b i2
powieściowe	p o v i e sj tsj o v e
chamfort	h a m f o r t
tango"-	t a n g o
radosna	r a d o s n a
warszawskiej	v a r S a v s k i e j
nazbyt	n a z b i2 t
er	e r
zaistnieć	z a i s t n i e tsj
bogiem	b o g i e m
rochefoucauld	r o h e f o u c a u l d
napisanego	n a p i s a n e g o
panny	p a n n i2
zbroje	z b r o j e
przyjemnością	p S i2 j e m n o sj tsj oc5
podlegającego	p o d l e g a j oc5 c e g o
wróżenia	v r u Z e n i a
polega	p o l e g a
li	l j
dobrych	d o b r i2 h
grupie	g r u p i e
czekającej	tS e k a j oc5 c e j
myśleć	m i2 sj l e tsj
tli	t l j
dot	d o t
jednak	j e d n a k
dosięgnął	d o sj eo5 g n oc5 w
pozorem	p o z o r e m
pochodach	p o h o d a h
rozmawiały	r o z m a v i a w i2
waliło	v a l j w o
robiłam	r o b i w a m
wybiera	v i2 b i e r a
samozachowawczy	s a m o z a h o v a v tS i2
nową	n o v oc5
prostu	p r o s t u
filtru	f i l t r u
kosmosie	k o s m o sj e
check	h e c k
zakazywać	z a k a z i2 v a tsj
imienia	i m i e n i a
przyjaciółmi	p S i2 j a tsj u w m i
idiotyczny	i d j o t i2 tS n i2
zarówno	z a r u v n o
wojskowych	v o j s k o v i2 h
cienkie	tsj e n k i e
jednakowoż	j e d n a k o v o S
92	eo5 tsj d
całkowicie	c a w k o v i tsj e
pisarskim	p i s a r s k i m
sumienia	s u m i e n i a
ukrywają	u k r i2 v a j oc5
uruchamiamy	u r u h a m i a m i2
prasie	p r a sj e
oko	o k o
nieruchomości	n i e r u h o m o sj tsj i
zyskały	z i2 s k a w i2
średnią	sj r e d n i oc5
narzeczona	n a Z e tS o n a
wiernych	v i e r n i2 h
wierzących	v i e Z oc5 c i2 h
hajduna	h a j d u n a
błyszczącym	b w i2 S tS oc5 c i2 m
oddaję	o d d a j e
leków	l e k u v
osobistego	o s o b i s t e g o
ukrytą	u k r i2 t oc5
luksusowa	l u k s u s o v a
otrzymane	o t S i2 m a n e
odwrót-	o d v r u t
przyczynę	p S i2 tS i2 n e
myślała	m i2 sj l a w a
artykuły	a r t i2 k u w i2
krainie	k r a i n i e
mówił	m u v i w
magnetofonów	m a g n e t o f o n u v
wariatki	v a r j a t k i
sportu	s p o r t u
tradycji	t r a d i2 c j i
zalewa	z a l e v a
williama	v i l l j a m a
przychodzi	p S i2 h o dzj i
dzięki	dzj eo5 k i
taktu	t a k t u
poobijanych	p o o b i j a n i2 h
czystą	tS i2 s t oc5
domowi	d o m o v i
zapędził	z a p eo5 dzj i w
praktycznym	p r a k t i2 tS n i2 m
burze	b u Z e
for	f o r
słuchamy	s w u h a m i2
głównych	g w u v n i2 h
zrozumieniem	z r o z u m i e n i e m
ponurej	p o n u r e j
twoimi	t f o i m i
stopami	s t o p a m i
kina	k i n a
cywilizacji	c i2 v i l j z a c j i
znalazła	z n a l a z w a
the	t h e
błędnymi	b w eo5 d n i2 m i
chwilka	h v i l k a
dodamy	d o d a m i2
jeździł	j e zj dzj i w
chin	h j n
zmarłego	z m a r w e g o
rzadkie!-	Z a t k i e e
zachować	z a h o v a tsj
piórami	p i u r a m i
stale	s t a l e
bonanzy	b o n a n z i2
herbaty	h e r b a t i2
homera	h o m e r a
planami	p l a n a m i
twojej	t f o j e j
owładnięta	o v w a d n i eo5 t a
zwyciężył	z v i2 tsj eo5 Z i2 w
wygrałam	v i2 g r a w a m
określona	o k r e sj l o n a
odrzuceniem	o d Z u c e n i e m
puchatek	p u h a t e k
czytał	tS i2 t a w
dokładnie	d o k w a d n i e
swych	s v i2 h
pamięta	p a m i eo5 t a
powodu	p o v o d u
fakt	f a k t
niosącą	n i o s oc5 c oc5
czasie	tS a sj e
czyhającego	tS i2 h a j oc5 c e g o
wf	v f
filharmonii	f i l h a r m o n i i
zwrócić	z v r u tsj i tsj
stałaś	s t a w a sj
wysokiego	v i2 s o k i e g o
wzruszyłaś	v z r u S i2 w a sj
spędziła	s p eo5 dzj i w a
dostrzegłby	d o s t S e g w b i2
szczęśliwym	S tS eo5 sj l j v i2 m
lęk	l eo5 k
remake	r e m a k e
zganiał	z g a n i a w
wciąż	v tsj oc5 S
b-29	b e d eo5 tsj
istnienia	i s t n i e n i a
zdaje	z d a j e
bronią	b r o n i oc5
przypisana	p S i2 p i s a n a
przyczynach	p S i2 tS i2 n a h
pogrzebania	p o g Z e b a n i a
dziele	dzj e l e
użycia	u Z i2 tsj a
dźwięki	dzj v i eo5 k i
buduje	b u d u j e
ujmującą	u j m u j oc5 c oc5
zajmujący	z a j m u j oc5 c i2
plan	p l a n
zostawiając	z o s t a v i a j oc5 c
ukojonej	u k o j o n e j
gazet	g a z e t
mikołaja	m i k o w a j a
serialach	s e r j a l a h
zamachy	z a m a h i2
swoich	s v o i h
status	s t a t u s
podatków	p o d a t k u v
rozumiem	r o z u m i e m
próg	p r u g
świetna	sj v i e t n a
windzie	v i n dzj e
magiczną	m a g i tS n oc5
śmierci	sj m i e r tsj i
daleko	d a l e k o
podobnego	p o d o b n e g o
traciłam	t r a tsj i w a m
sensie	s e n sj e
razu	r a z u
podwajał	p o d v a j a w
siatkowym	tsj a t k o v i2 m
witherspoon	v i t h e r s p o o n
podnosić	p o d n o sj i tsj
państwa	p a n~ s t f a
względów	v z g l eo5 d u v
facet	f a c e t
wywiadowi	v i2 v i a d o v i
anarchistkę	a n a r h j s t k e
nęcąca	n eo5 c oc5 c a
zmarłemu	z m a r w e m u
zaciągi	z a tsj oc5 g i
kochać	k o h a tsj
kręgi	k r eo5 g i
furii	f u r j i
konspiratorzy	k o n s p i r a t o Z i2
gruba	g r u b a
przebywa	p S e b i2 v a
zasadzie	z a s a dzj e
podarować	p o d a r o v a tsj
używając	u Z i2 v a j oc5 c
wirefusion	v i r e f u sj o n
nieskończonych	n i e s k o n~ tS o n i2 h
badania	b a d a n i a
wagi	v a g i
toczonych	t o tS o n i2 h
przychodzę	p S i2 h o dz e
miłość-	m i w o sj tsj e
brakiem	b r a k i e m
kalkulacyjny	k a l k u l a c i2 j n i2
wypada	v i2 p a d a
ziemię	zj e m i e
dziedzinie	dzj e dzj i n i e
zbawienia	z b a v i e n i a
szpad	S p a d
robisz	r o b i S
od	o d
aż	a S
gdzież	g dzj e S
przybiorą	p S i2 b i o r oc5
przymocowane	p S i2 m o c o v a n e
rozumu	r o z u m u
zmniejsza	z m n i e j S a
rozległość	r o z l e g w o sj tsj
wspólnej	v s p u l n e j
paliłem	p a l j w e m
ogródek	o g r u d e k
start	s t a r t
dziewictwa	dzj e v i c t f a
ostatnim	o s t a t n i m
iluzji	i l u z j i
nieodwołalną	n i e o d v o w a l n oc5
poskrzypiałem	p o s k S i2 p i a w e m
unikaj	u n i k a j
chłopak	h w o p a k
ostatni	o s t a t n i
talerzem	t a l e Z e m
love	l o f e
zyskałam	z i2 s k a w a m
kresu	k r e s u
nasz	n a S
podejrzeń	p o d e j Z e n~
sprawiedliwości	s p r a v i e d l j v o sj tsj i
lasy	l a s i2
paranoją	p a r a n o j oc5
chciałoby	h tsj a w o b i2
domogarow	d o m o g a r o v
nabierający	n a b i e r a j oc5 c i2
ok	o k
emocjonalnych	e m o c j o n a l n i2 h
kubusia	k u b u tsj a
radośnie	r a d o sj n i e
biodrach	b i o d r a h
częściej	tS eo5 sj tsj e j
kojarzy	k o j a Z i2
powodować	p o v o d o v a tsj
obiektu	o b i e k t u
big	b i g
stał	s t a w
dziady	dzj a d i2
kolejnego	k o l e j n e g o
niczym	n i tS i2 m
futrzaną	f u t S a n oc5
domogarowa	d o m o g a r o v a
prosto	p r o s t o
skromnie	s k r o m n i e
podobnych	p o d o b n i2 h
jednocześnie	j e d n o tS e sj n i e
ma-	m a e
lubi	l u b i
literackiego	l j t e r a c k i e g o
ważniejsze	v a Z n i e j S e
even	e f e n
zakochać	z a k o h a tsj
popularna	p o p u l a r n a
włoch	v w o h
zainteresowanie	z a i n t e r e s o v a n i e
szerszą	S e r S oc5
narzędziem	n a Z eo5 dzj e m
103	s t o S i2
bywa	b i2 v a
zlikwidować	z l j k f i d o v a tsj
mistrz	m i s t S
grabów	g r a b u v
zaprawieni	z a p r a v i e n i
spędzonych	s p eo5 dz o n i2 h
zrozumiał	z r o z u m i a w
dziwi	dzj i v i
zabójczym	z a b u j tS i2 m
kiszonych	k i S o n i2 h
dzieł	dzj e w
małego	m a w e g o
albumu	a l b u m u
potrawa	p o t r a v a
przyzwoitości-	p S i2 z v o i t o sj tsj i e
chętka	h eo5 t k a
współczesności	v s p u w tS e s n o sj tsj i
zrobienia	z r o b i e n i a
przypuszczać	p S i2 p u S tS a tsj
ujęć	u j eo5 tsj
głąb	g w oc5 b
włoskiego	v w o s k i e g o
pułapki	p u w a p k i
małe	m a w e
wenus	v e n u s
jakąkolwiek	j a k oc5 k o l v i e k
równię	r u v n i e
ciebie	tsj e b i e
sprawiedliwość	s p r a v i e d l j v o sj tsj
kupującym	k u p u j oc5 c i2 m
trzema	t S e m a
nieczytany	n i e tS i2 t a n i2
miecz	m i e tS
dorośli	d o r o sj l j
d	d
przygotował	p S i2 g o t o v a w
inna	i n n a
dowodzą	d o v o dz oc5
bombowe	b o m b o v e
został	z o s t a w
nachylił	n a h i2 l j w
dobiega	d o b i e g a
oblepiony	o b l e p i o n i2
eucharystii	e u h a r i2 s t j i
rzeczywisty	Z e tS i2 v i s t i2
hipercieniutkich	h j p e r tsj e n i u t k i h
sytuacja	s i2 t u a c j a
nikołajewicza	n i k o w a j e v i tS a
kultowym	k u l t o v i2 m
koniecznie	k o n i e tS n i e
szczęśliwa	S tS eo5 sj l j v a
biblijne	b i b l j j n e
polowaniu	p o l o v a n i u
ręce	r eo5 c e
intymne	i n t i2 m n e
twoich	t f o i h
ud	u d
huczy	h u tS i2
róża	r u Z a
widzimy	v i dzj i m i2
formą	f o r m oc5
córkę	c u r k e
jerzego	j e Z e g o
wymyśliłam	v i2 m i2 sj l j w a m
zejdź	z e j dzj
biedy	b i e d i2
uchodził	u h o dzj i w
czerpać	tS e r p a tsj
przeszukiwała	p S e S u k i v a w a
planet	p l a n e t
struchlała	s t r u h l a w a
nakładam	n a k w a d a m
mówi	m u v i
drewnianych	d r e v n i a n i2 h
równie	r u v n i e
zdumiewać	z d u m i e v a tsj
ojcze	o j tS e
zachodnich	z a h o d n i h
głosząc	g w o S oc5 c
metafory	m e t a f o r i2
rokujące	r o k u j oc5 c e
rozwija	r o z v i j a
ołowiu	o w o v i u
szept	S e p t
prousta	p r o u s t a
ogromną	o g r o m n oc5
czy	tS i2
morza	m o Z a
kierkegaarda	k i e r k e g a a r d a
pomści	p o m sj tsj i
idioty	i d j o t i2
mogąc	m o g oc5 c
obietnicą	o b i e t n i c oc5
szyi	S i2 i
wystarczy	v i2 s t a r tS i2
przyjaciel	p S i2 j a tsj e l
szedł	S e d w
łowiłem	w o v i w e m
umarli	u m a r l j
podstawowymi	p o d s t a v o v i2 m i
słowiańską	s w o v i a n~ s k oc5
morskim	m o r s k i m
główny	g w u v n i2
surowa	s u r o v a
generacja	g e n e r a c j a
starokawalerskie	s t a r o k a v a l e r s k i e
radio	r a d j o
a	a
impreza	i m p r e z a
lekkomyślny	l e k k o m i2 sj l n i2
300	o t
wojny	v o j n i2
własne	v w a s n e
skóry	s k u r i2
rozwiązywać	r o z v i oc5 z i2 v a tsj
praktyce	p r a k t i2 c e
jedynie	j e d i2 n i e
zabrał	z a b r a w
szkół	S k u w
spontaniczny	s p o n t a n i tS n i2
zbigniewa	z b i g n i e v a
rybczyńskiego	r i2 b tS i2 n~ s k i e g o
przezwyciężyć	p S e z v i2 tsj eo5 Z i2 tsj
podległych	p o d l e g w i2 h
pojednany	p o j e d n a n i2
ulicy	u l j c i2
dotknęło	d o t k n eo5 w o
muły	m u w i2
gwałciciel	g v a w c i tsj e l
szaty	S a t i2
marii	m a r j i
tobie	t o b i e
rezydentem	r e z i2 d e n t e m
słowy	s w o v i2
atletami	a t l e t a m i
dzisiejszym	dzj i sj e j S i2 m
językiem	j eo5 z i2 k i e m
cywilizacyjnego	c i2 v i l j z a c i2 j n e g o
hemoroidów	h e m o r o i d u v
podjąłeś	p o d j oc5 w e sj
nieodpartą	n i e o d p a r t oc5
grunt	g r u n t
ostatnio	o s t a t n i o
wreszcie	v r e S tsj e
niechaj	n i e h a j
uchronić	u h r o n i tsj
polami	p o l a m i
stendhala	s t e n d h a l a
zatem	z a t e m
zakorzenione	z a k o Z e n i o n e
dla	d l a
by	b i2
siecią	sj e tsj oc5
hokejowego	h o k e j o v e g o
conieco	c o n i e c o
zakazuje	z a k a z u j e
warunki	v a r u n k i
wstępie	v s t eo5 p i e
powinien	p o v i n i e n
skupionej	s k u p i o n e j
tuszem	t u S e m
wiemy	v i e m i2
uduchowioną	u d u h o v i o n oc5
interaktywne	i n t e r a k t i2 v n e
to-	t o
krem	k r e m
idealną	i d e a l n oc5
zobaczyć	z o b a tS i2 tsj
przygotowany	p S i2 g o t o v a n i2
przyjaciela	p S i2 j a tsj e l a
wyrzec	v i2 Z e c
wyszło	v i2 S w o
kawałki	k a v a w k i
ubierała	u b i e r a w a
udzielić	u dzj e l j tsj
może	m o Z e
wspieranie	v s p i e r a n i e
przeklęty	p S e k l eo5 t i2
dysku	d i2 s k u
naukowiec	n a u k o v i e c
optymizmu	o p t i2 m i z m u
baletem	b a l e t e m
używam	u Z i2 v a m
leczy	l e tS i2
udaną	u d a n oc5
molestowania	m o l e s t o v a n i a
serii	s e r j i
mówią	m u v i oc5
mcintosh	m tsj i n t o s h
nią	n i oc5
wyznaniem	v i2 z n a n i e m
dbać	d b a tsj
czasu	tS a s u
perspektywy	p e r s p e k t i2 v i2
potomnym	p o t o m n i2 m
plwocina	p l v o tsj i n a
znanej	z n a n e j
kurtynę	k u r t i2 n e
banku	b a n k u
piszę	p i S e
wszechstronnie	v S e h s t r o n n i e
zdaniach	z d a n i a h
encyklopedii	e n c i2 k l o p e d j i
prawni	p r a v n i
tytuł	t i2 t u w
wiem	v i e m
taśmie	t a sj m i e
obok	o b o k
francuskiej	f r a n c u s k i e j
chociaż	h o tsj a S
zafałszowanie	z a f a w S o v a n i e
oryginału	o r i2 g i n a w u
urodzenia	u r o dz e n i a
książce	k tsj oc5 Z c e
doświadczasz	d o sj v i a d tS a S
rezygnacji	r e z i2 g n a c j i
nieszczęścia	n i e S tS eo5 sj tsj a
biedni	b i e d n i
graf	g r a f
odległym	o d l e g w i2 m
historyczne	h j s t o r i2 tS n e
miejsce	m i e j s c e
przytrafiło	p S i2 t r a f i w o
wannie	v a n n i e
zginając	z g i n a j oc5 c
wspaniały	v s p a n i a w i2
wielkości	v i e l k o sj tsj i
myszkina-	m i2 S k i n a e
sprawia	s p r a v i a
wynoszenie	v i2 n o S e n i e
odleciał	o d l e tsj a w
hillary	h j l l a r i2
określić-	o k r e sj l j tsj e
rest	r e s t
r	r
starokawalerskich	s t a r o k a v a l e r s k i h
problemami	p r o b l e m a m i
mury	m u r i2
dębowych	d eo5 b o v i2 h
pani	p a n i
sponsorowi	s p o n s o r o v i
dzisiaj	dzj i tsj a j
trwoni	t r v o n i
jawna	j a v n a
wargi	v a r g i
klawesynie	k l a v e s i2 n i e
kolorowej	k o l o r o v e j
100	s t o t
krążka	k r oc5 Z k a
istniejące	i s t n i e j oc5 c e
eksperci	e k s p e r tsj i
1	s t
wzorce	v z o r c e
wynalazcy	v i2 n a l a z c i2
najdrobniejsza	n a j d r o b n i e j S a
jednej	j e d n e j
telewizji	t e l e v i z j i
kordiana	k o r d j a n a
wayne	v a i2 n e
twoje	t f o j e
pozwoli	p o z v o l j
dążeniu	d oc5 Z e n i u
wraz	v r a z
zrezygnowała	z r e z i2 g n o v a w a
teoria	t e o r j a
nawilżający	n a v i l Z a j oc5 c i2
wódz	v u dz
literki	l j t e r k i
zwykle	z v i2 k l e
wstają	v s t a j oc5
stąpać	s t oc5 p a tsj
have	h a f e
wosk	v o s k
rzekomej	Z e k o m e j
trader.pl	t r a d e r p l
dano	d a n o
ustrzec	u s t S e c
za	z a
robimy	r o b i m i2
5	n tsj
ufać	u f a tsj
absurd	a b s u r d
gdyby	g d i2 b i2
stuprocentowych	s t u p r o c e n t o v i2 h
prywatny	p r i2 v a t n i2
igrać	i g r a tsj
kłopot	k w o p o t
pisarza	p i s a Z a
faktycznie	f a k t i2 tS n i e
wiedziony	v i e dzj o n i2
właściwie	v w a sj tsj i v i e
cnoty	c n o t i2
manierę	m a n i e r e
lolkiem	l o l k i e m
umierania	u m i e r a n i a
pisałem	p i s a w e m
kontekst	k o n t e k s t
twojego	t f o j e g o
pępkiem	p eo5 p k i e m
uczesanie	u tS e s a n i e
publiczni	p u b l j tS n i
kostiumów	k o s t j u m u v
muszą	m u S oc5
przeprowadzać	p S e p r o v a dz a tsj
pokolenie	p o k o l e n i e
przypadku	p S i2 p a t k u
rodzaju	r o dz a j u
zagrałaś	z a g r a w a sj
ostatniej	o s t a t n i e j
rozgrywa	r o z g r i2 v a
nam	n a m
życia	Z i2 tsj a
deski	d e s k i
mechaniczna	m e h a n i tS n a
uczucia	u tS u tsj a
jaw	j a v
twierdzimy	t f i e r dzj i m i2
doznawszy	d o z n a v S i2
rzędu	Z eo5 d u
wcielił	v tsj e l j w
nowiem	n o v i e m
który	k t u r i2
niemców	n i e m c u v
pokazują	p o k a z u j oc5
serię	s e r j e
wypędzony	v i2 p eo5 dz o n i2
odczuwamy	o d tS u v a m i2
pełnym	p e w n i2 m
sposoby	s p o s o b i2
południowych	p o w u d n i o v i2 h
rozwiązaniem	r o z v i oc5 z a n i e m
źródła	zj r u d w a
szóstą	S u s t oc5
chcą	h c oc5
kosmetyków	k o s m e t i2 k u v
wewnętrznie	v e v n eo5 t S n i e
zawsze	z a v S e
wędrując	v eo5 d r u j oc5 c
wiarą	v i a r oc5
biochemik	b i o h e m i k
zające	z a j oc5 c e
pomalowała	p o m a l o v a w a
kwiatów	k f i a t u v
działalności	dzj a w a l n o sj tsj i
reasumując	r e a s u m u j oc5 c
prawdę	p r a v d e
rozmowy	r o z m o v i2
tancerką	t a n c e r k oc5
wieży	v i e Z i2
książkę	k tsj oc5 Z k e
niepotrzebującym	n i e p o t S e b u j oc5 c i2 m
czynienia	tS i2 n i e n i a
wyszukiwarki	v i2 S u k i v a r k i
udowodnienie	u d o v o d n i e n i e
cesarza-	c e s a Z a e
zasypia	z a s i2 p i a
odbywać	o d b i2 v a tsj
wystawione	v i2 s t a v i o n e
instrukcja	i n s t r u k c j a
figurę	f i g u r e
utkanym	u t k a n i2 m
poznaniem	p o z n a n i e m
świętego	sj v i eo5 t e g o
wyglądasz	v i2 g l oc5 d a S
lokalnej	l o k a l n e j
neuschwanstein	n e u s h v a n s t e i n
twoją	t f o j oc5
tym	t i2 m
europy	e u r o p i2
doznając	d o z n a j oc5 c
wichry	v i h r i2
pojawia	p o j a v i a
łabędzie	w a b eo5 dzj e
ważny	v a Z n i2
mi	m i
młot	m w o t
och	o h
będziemy	b eo5 dzj e m i2
niepodzielną	n i e p o dzj e l n oc5
iluzoryczna	i l u z o r i2 tS n a
kręcących	k r eo5 c oc5 c i2 h
granic	g r a n i c
doświadczeniu	d o sj v i a d tS e n i u
prozac	p r o z a c
postępowania-	p o s t eo5 p o v a n i a e
nieogarnione	n i e o g a r n i o n e
wieści	v i e sj tsj i
powtarzając	p o v t a Z a j oc5 c
naładowanych	n a w a d o v a n i2 h
wisły	v i s w i2
rozsądku	r o z s oc5 t k u
jelenich	j e l e n i h
zbudował	z b u d o v a w
zawodowa	z a v o d o v a
dzieckiem	dzj e c k i e m
targać	t a r g a tsj
ulotne	u l o t n e
znika	z n i k a
artystów	a r t i2 s t u v
dzień	dzj e n~
południowe	p o w u d n i o v e
pomyśle	p o m i2 sj l e
6	tsj e
powiedz	p o v i e dz
d)-	d e
zginął	z g i n oc5 w
polskiego	p o l s k i e g o
pecha	p e h a
łatwo	w a t f o
wszelkiego	v S e l k i e g o
dłonie	d w o n i e
kozła	k o z w a
równoległego	r u v n o l e g w e g o
kafkowski	k a f k o v s k i
jenże	j e n Z e
uzyskać	u z i2 s k a tsj
wzmocnić	v z m o c n i tsj
dziwnie	dzj i v n i e
potrzebują	p o t S e b u j oc5
zapartym	z a p a r t i2 m
kochankami	k o h a n k a m i
widzenia	v i dz e n i a
najpierw	n a j p i e r v
uczynił	u tS i2 n i w
896	o sj eo5 tsj tsj e
osadzoną	o s a dz o n oc5
boisz	b o i S
instynkt	i n s t i2 n k t
mówić	m u v i tsj
historia	h j s t o r j a
stref	s t r e f
piętrze	p i eo5 t S e
wieść	v i e sj tsj
archiwizacją	a r h j v i z a c j oc5
wojennej	v o j e n n e j
niewiele	n i e v i e l e
karierę	k a r j e r e
romansów	r o m a n s u v
emerytowany	e m e r i2 t o v a n i2
oczu	o tS u
problemy	p r o b l e m i2
nikogo	n i k o g o
doszedł	d o S e d w
odkryto	o t k r i2 t o
wyjechać	v i2 j e h a tsj
litaka	l j t a k a
tłumacz	t w u m a tS
żartuje	Z a r t u j e
pewno	p e v n o
niebieskiemu	n i e b i e s k i e m u
czeka	tS e k a
stron	s t r o n
swym	s v i2 m
żyje	Z i2 j e
doświadczenia	d o sj v i a d tS e n i a
epokę	e p o k e
brakujące	b r a k u j oc5 c e
potrafimy	p o t r a f i m i2
sprawić	s p r a v i tsj
animacja	a n i m a c j a
dzikie	dzj i k i e
zamiast	z a m i a s t
jesteście	j e s t e sj tsj e
winy	v i n i2
rewolucję	r e v o l u c j e
klucz	k l u tS
papież	p a p i e S
straszliwą	s t r a S l j v oc5
andrzej	a n d Z e j
n	n
szczęście	S tS eo5 sj tsj e
ponieważ	p o n i e v a S
książkach	k tsj oc5 Z k a h
wracam	v r a c a m
błahym	b w a h i2 m
rokiem	r o k i e m
tych	t i2 h
dalekich	d a l e k i h
margrafom	m a r g r a f o m
uprawianie	u p r a v i a n i e
wiadomości	v i a d o m o sj tsj i
dało	d a w o
pochłonięte	p o h w o n i eo5 t e
hierarchię	h j e r a r h j e
wydającą	v i2 d a j oc5 c oc5
udało	u d a w o
alkoholicy	a l k o h o l j c i2
organizacji	o r g a n i z a c j i
niewymagającym	n i e v i2 m a g a j oc5 c i2 m
kolidować	k o l j d o v a tsj
kolorów	k o l o r u v
przekroczył	p S e k r o tS i2 w
śpiewka	sj p i e v k a
porażki	p o r a Z k i
wytatuowałeś	v i2 t a t u o v a w e sj
oscar	o s c a r
boju	b o j u
chałupniczym	h a w u p n i tS i2 m
pornografię	p o r n o g r a f i e
szybkość	S i2 b k o sj tsj
przypadkowe	p S i2 p a t k o v e
język	j eo5 z i2 k
skąd	s k oc5 d
wyprowadzając	v i2 p r o v a dz a j oc5 c
messyny	m e S i2 n i2
tajlandzka	t a j l a n dz k a
spoczywa	s p o tS i2 v a
twoim	t f o i m
czynności	tS i2 n n o sj tsj i
informacji	i n f o r m a c j i
nakrycia	n a k r i2 tsj a
wysnuć	v i2 s n u tsj
wystawił	v i2 s t a v i w
b-1b	b e tS t b
krzyża	k S i2 Z a
kobiecych	k o b i e c i2 h
rytuałem	r i2 t u a w e m
żałośnie	Z a w o sj n i e
kołysany	k o w i2 s a n i2
wajdzie	v a j dzj e
trzeba	t S e b a
postąpisz	p o s t oc5 p i S
pisarz	p i s a S
mówiąc	m u v i oc5 c
zaszczepiona	z a S tS e p i o n a
ujarzmił	u j a Z m i w
orfeuszu	o r f e u S u
cichego	tsj i h e g o
niewyrażalny	n i e v i2 r a Z a l n i2
pan	p a n
tchnie	t h n i e
gry	g r i2
włóczęga	v w u tS eo5 g a
bylibyśmy	b i2 l j b i2 sj m i2
one	o n e
oczyma	o tS i2 m a
dni	d n i
skaner	s k a n e r
silnym	sj i l n i2 m
podciągaj	p o d tsj oc5 g a j
zapoznać	z a p o z n a tsj
kolumn	k o l u m n
pracowników	p r a c o v n i k u v
pracujące	p r a c u j oc5 c e
soli	s o l j
aktorem	a k t o r e m
życia-	Z i2 tsj a e
wielkie	v i e l k i e
drogę	d r o g e
wyszywaniu	v i2 S i2 v a n i u
słowiański	s w o v i a n~ s k i
wyprawy	v i2 p r a v i2
okien	o k i e n
wnętrza	v n eo5 t S a
doświadczeniami	d o sj v i a d tS e n i a m i
o	o
gero	g e r o
przyjaciółki	p S i2 j a tsj u w k i
ludźmi	l u dzj m i
pokoje	p o k o j e
rzadkości	Z a t k o sj tsj i
szkolnej	S k o l n e j
łatwiej	w a t f i e j
kości	k o sj tsj i
pójdziemy	p u j dzj e m i2
szkołę	S k o w e
problemów	p r o b l e m u v
jął	j oc5 w
pozytywnie	p o z i2 t i2 v n i e
strun	s t r u n
nieślubny	n i e sj l u b n i2
skrzą	s k S oc5
chardina	h a r d j n a
zacząłem	z a tS oc5 w e m
sprowadzał	s p r o v a dz a w
zwierciadłem	z v i e r tsj a d w e m
maszyny	m a S i2 n i2
stołku	s t o w k u
upstrzonym	u p s t S o n i2 m
palenia	p a l e n i a
spać	s p a tsj
nałożysz	n a w o Z i2 S
miłośników	m i w o sj n i k u v
obejrzeć	o b e j Z e tsj
milczeniem	m i l tS e n i e m
wiek	v i e k
kluczowego	k l u tS o v e g o
oczom	o tS o m
kluczowymi	k l u tS o v i2 m i
zosia	z o tsj a
depresji	d e p r e s j i
jestem	j e s t e m
wleźć	v l e zj tsj
śmiertelników	sj m i e r t e l n i k u v
strażniczko	s t r a Z n i tS k o
kolejkowe	k o l e j k o v e
krótki	k r u t k i
uratować	u r a t o v a tsj
składankę	s k w a d a n k e
pokładzie	p o k w a dzj e
najbliższej	n a j b l j Z S e j
bohater	b o h a t e r
metafizyka	m e t a f i z i2 k a
cesarz	c e s a S
radiu	r a d j u
obwałował	o b v a w o v a w
rozpoczęcie	r o z p o tS eo5 tsj e
lutyki	l u t i2 k i
uznawaniu	u z n a v a n i u
wideo	v i d e o
postawisz	p o s t a v i S
braterskiej	b r a t e r s k i e j
zdjęciu-	z d j eo5 tsj u
obnażał	o b n a Z a w
systemu	s i2 s t e m u
utworzą	u t f o Z oc5
nazwana	n a z v a n a
przedziwną	p S e dzj i v n oc5
polskiej-	p o l s k i e j e
herrenchiemsee	h e r r e n h j e m s e e
grać	g r a tsj
arystotelesie	a r i2 s t o t e l e sj e
ludzkiej	l u dz k i e j
intuicją	i n t u i c j oc5
żadnej	Z a d n e j
staraj	s t a r a j
ramion	r a m i o n
poetykę	p o e t i2 k e
ta	t a
akt	a k t
ofiary	o f i a r i2
uległo	u l e g w o
przenosili	p S e n o sj i l j
poległych	p o l e g w i2 h
krążki	k r oc5 Z k i
stulecia	s t u l e tsj a
sposób	s p o s u b
fragmenty	f r a g m e n t i2
ubierać	u b i e r a tsj
kalkulacyjnym	k a l k u l a c i2 j n i2 m
princess	p r j n c e S
skład	s k w a d
pewne	p e v n e
oceną	o c e n oc5
załogi	z a w o g i
zdarzyć	z d a Z i2 tsj
chce	h c e
rybaków	r i2 b a k u v
agresji	a g r e s j i
chwilą	h v i l oc5
przyjaciółką	p S i2 j a tsj u w k oc5
żadnego	Z a d n e g o
jego	j e g o
modlił	m o d l j w
rzut	Z u t
rok	r o k
wozów	v o z u v
liście	l j sj tsj e
poszukującym	p o S u k u j oc5 c i2 m
aktorów	a k t o r u v
kolorze	k o l o Z e
jedno	j e d n o
blisko	b l j s k o
uodparnia	u o d p a r n i a
żyła	Z i2 w a
jej	j e j
rodzić	r o dzj i tsj
przedstawia	p S e d s t a v i a
dzieciństwo	dzj e tsj i n~ s t f o
planu	p l a n u
łagodni	w a g o d n i
niższości	n i Z S o sj tsj i
klęsce	k l eo5 s c e
nieznanej	n i e z n a n e j
tradycyjnie	t r a d i2 c i2 j n i e
opiekuńczy	o p i e k u n~ tS i2
obliczeń	o b l j tS e n~
jesteś	j e s t e sj
spracowaną	s p r a c o v a n oc5
kwestię	k f e s t j e
stronicami	s t r o n i c a m i
punktu	p u n k t u
niccolo	n i c c o l o
miałam	m i a w a m
oczywiście	o tS i2 v i sj tsj e
postaci	p o s t a tsj i
wiecie	v i e tsj e
ucieka	u tsj e k a
małych	m a w i2 h
wysokości	v i2 s o k o sj tsj i
złem	z w e m
osiągnięcie	o tsj oc5 g n i eo5 tsj e
kamienice	k a m i e n i c e
pieczołowicie	p i e tS o w o v i tsj e
dziwki	dzj i v k i
dowód	d o v u d
sklepionym	s k l e p i o n i2 m
7	e
ojczyzna	o j tS i2 z n a
innego	i n n e g o
sprawiło	s p r a v i w o
działa	dzj a w a
filmie	f i l m i e
jedynki	j e d i2 n k i
zajmującą	z a j m u j oc5 c oc5
ladena	l a d e n a
podręczniki	p o d r eo5 tS n i k i
podobnym	p o d o b n i2 m
zepsutej	z e p s u t e j
przebiegać	p S e b i e g a tsj
podsuniętym	p o d s u n i eo5 t i2 m
położyć	p o w o Z i2 tsj
okazja	o k a z j a
psem	p s e m
liberalizm	l j b e r a l j z m
bbc	b b c
sasami	s a s a m i
windsurfingowej	v i n d s u r f i n g o v e j
przygodę	p S i2 g o d e
glow	g l o v
szczędzą	S tS eo5 dz oc5
manii	m a n i i
tysiące	t i2 tsj oc5 c e
ciąg	tsj oc5 g
wybrzeże	v i2 b Z e Z e
oparami	o p a r a m i
dziwnych	dzj i v n i2 h
tyrana	t i2 r a n a
matką	m a t k oc5
itza	i t z a
szansę	S a n s e
buntu	b u n t u
zastanawiam	z a s t a n a v i a m
uczucie	u tS u tsj e
głosimy	g w o sj i m i2
wsze	v S e
testów	t e s t u v
partycji	p a r t i2 c j i
leczenia	l e tS e n i a
płonących	p w o n oc5 c i2 h
rozróżnić	r o z r u Z n i tsj
niedowagę	n i e d o v a g e
archiwizacji-	a r h j v i z a c j i e
podążył	p o d oc5 Z i2 w
krążenia	k r oc5 Z e n i a
franza	f r a n z a
takiego	t a k i e g o
roku	r o k u
duchem	d u h e m
oskarżony	o s k a r Z o n i2
rouge	r o u g e
złoża	z w o Z a
przypisując	p S i2 p i s u j oc5 c
podobno	p o d o b n o
lęku	l eo5 k u
natura	n a t u r a
władca	v w a d c a
ogień	o g i e n~
istotę	i s t o t e
chatka	h a t k a
brudne	b r u d n e
przypomnieć	p S i2 p o m n i e tsj
postrzegana	p o s t S e g a n a
buki	b u k i
ławrze	w a v Z e
upływ	u p w i2 v
joni	j o n i
odmaterializował	o d m a t e r j a l j z o v a w
miarą	m i a r oc5
poznać	p o z n a tsj
wypływają	v i2 p w i2 v a j oc5
urlop	u r l o p
kompleks	k o m p l e k s
aberracją	a b e r r a c j oc5
puzon	p u z o n
przemyka	p S e m i2 k a
nimfomanki	n i m f o m a n k i
ładną	w a d n oc5
cztery	tS t e r i2
rzuciła	Z u tsj i w a
istnienie	i s t n i e n i e
dziecko	dzj e c k o
jakim	j a k i m
waragi-	v a r a g i e
kielich	k i e l j h
wszechmocy	v S e h m o c i2
kolejne	k o l e j n e
odetchnęły	o d e t h n eo5 w i2
prywatnym	p r i2 v a t n i2 m
nosisz	n o sj i S
sprząta	s p S oc5 t a
she	s h e
zegar	z e g a r
nacisku	n a tsj i s k u
ruch	r u h
kto	k t o
najgorsza	n a j g o r S a
słodkimi	s w o t k i m i
ojciec	o j tsj e c
dworu	d v o r u
miotał	m i o t a w
rozważnie	r o z v a Z n i e
proces	p r o c e s
pozwolił	p o z v o l j w
zdrowiu-	z d r o v i u
okolicach	o k o l j c a h
łukasz	w u k a S
skarby	s k a r b i2
bodaj	b o d a j
celem	c e l e m
ciała	tsj a w a
zostały	z o s t a w i2
inch)-	i n c h
domu	d o m u
nowa	n o v a
tłumaczyła	t w u m a tS i2 w a
b-52	b e p i d
niemieckiemu	n i e m i e c k i e m u
zgodziliby	z g o dzj i l j b i2
wbrew	v b r e v
rozrywek	r o z r i2 v e k
zastąpić	z a s t oc5 p i tsj
parallel	p a r a l l e l
szli	S l j
skuteczniejsza	s k u t e tS n i e j S a
sekretów	s e k r e t u v
odpoczynek	o d p o tS i2 n e k
spalić	s p a l j tsj
dociekań	d o tsj e k a n~
usa	u s a
zachwytach	z a h v i2 t a h
osobnik	o s o b n i k
znamy	z n a m i2
malowany	m a l o v a n i2
ową	o v oc5
gdzieś	g dzj e sj
przypomnienie	p S i2 p o m n i e n i e
połączyłem	p o w oc5 tS i2 w e m
bowiem	b o v i e m
kreskówki	k r e s k u v k i
czasy	tS a s i2
kwaśnica	k f a sj n i c a
przeciwnikami	p S e tsj i v n i k a m i
trzynastozgłoskowcem	t S i2 n a s t o z g w o s k o v c e m
wydają	v i2 d a j oc5
nieistnienia	n i e i s t n i e n i a
koledzy	k o l e dz i2
uważałam	u v a Z a w a m
beatrycze	b e a t r i2 tS e
przynoszą	p S i2 n o S oc5
czterech	tS t e r e h
zawierają	z a v i e r a j oc5
rozkwitająca	r o z k f i t a j oc5 c a
czole	tS o l e
studia	s t u d j a
wielkim	v i e l k i m
kostiumowych	k o s t j u m o v i2 h
dziadek	dzj i a d e k
przerwa	p S e r v a
mogłam	m o g w a m
deser	d e s e r
kidzeną	k i dz e n oc5
przezorny	p S e z o r n i2
licznych	l j tS n i2 h
pośrednictwem	p o sj r e d n i c t f e m
słodkiego	s w o t k i e g o
programy	p r o g r a m i2
wtedy	v t e d i2
powołani	p o v o w a n i
wiązania	v i oc5 z a n i a
podejrzana	p o d e j Z a n a
doradza	d o r a dz a
roznosząc	r o z n o S oc5 c
wynosi	v i2 n o sj i
działanie	dzj a w a n i e
schizofrenii	s h j z o f r e n i i
prowadzi	p r o v a dzj i
następnie	n a s t eo5 p n i e
kierując	k i e r u j oc5 c
trudnością	t r u d n o sj tsj oc5
otwartymi	o t f a r t i2 m i
dziać	dzj a tsj
aktor	a k t o r
mieście	m i e sj tsj e
wzięła	v zj eo5 w a
poprawkę	p o p r a v k e
absolutnie	a b s o l u t n i e
porozumienie	p o r o z u m i e n i e
poznawania	p o z n a v a n i a
rojowiska	r o j o v i s k a
nic	n i c
kształtuje	k S t a w t u j e
ustach	u s t a h
większy	v i eo5 k S i2
meursaulta	m e u r s a u l t a
miłość	m i w o sj tsj
katalogu	k a t a l o g u
nudą	n u d oc5
nowego	n o v e g o
myślowym	m i2 sj l o v i2 m
skoncentrować	s k o n c e n t r o v a tsj
grzeszności	g Z e S n o sj tsj i
przemyt	p S e m i2 t
bezinteresowności	b e zj i n t e r e s o v n o sj tsj i
wyjątkowo	v i2 j oc5 t k o v o
okazje	o k a z j e
olejki	o l e j k i
zaznaczamy	z a z n a tS a m i2
kręciło	k r eo5 tsj i w o
przygotuj	p S i2 g o t u j
miałyby	m i a w i2 b i2
męstwa	m eo5 s t f a
czarnym	tS a r n i2 m
śmigłowca	sj m i g w o v c a
medialnego	m e d j a l n e g o
poznaliśmy	p o z n a l j sj m i2
kultem	k u l t e m
dołączymy	d o w oc5 tS i2 m i2
nieosiągalnego	n i e o tsj oc5 g a l n e g o
rozpaczliwie	r o z p a tS l j v i e
podobnie-	p o d o b n i e e
ping	p i n g
szlachetności	S l a h e t n o sj tsj i
spełniło	s p e w n i w o
pod	p o d
spróbować	s p r u b o v a tsj
wywiadu	v i2 v i a d u
przeciwko	p S e tsj i v k o
prądem	p r oc5 d e m
świadomość	sj v i a d o m o sj tsj
bajtów	b a j t u v
cieniu	tsj e n i u
dbała	d b a w a
głównego	g w u v n e g o
środku	sj r o t k u
wierny	v i e r n i2
edenu	e d e n u
ścisłości	sj tsj i s w o sj tsj i
bolkiem	b o l k i e m
pozostanie	p o z o s t a n i e
jasno	j a s n o
zwłaszcza	z v w a S tS a
precz	p r e tS
ń	n~
pozostającym	p o z o s t a j oc5 c i2 m
doświadczył	d o sj v i a d tS i2 w
sercu	s e r c u
ambasady	a m b a s a d i2
zmysłowo	z m i2 s w o v o
zagłada	z a g w a d a
pamiętniki	p a m i eo5 t n i k i
nieraz	n i e r a z
miłości	m i w o sj tsj i
paradzie	p a r a dzj e
wypad	v i2 p a d
firma	f i r m a
przykład	p S i2 k w a d
prezentują	p r e z e n t u j oc5
1-2-3	s t e d e S i2
may	m a i2
pierwszą	p i e r v S oc5
przedmiotem	p S e d m i o t e m
codziennie	c o dzj e n n i e
idzie	i dzj e
cezary	c e z a r i2
żalu	Z a l u
poruszała	p o r u S a w a
przeklętą	p S e k l eo5 t oc5
przenikają	p S e n i k a j oc5
nieśli	n i e sj l j
wergilego	v e r g i l e g o
50	p i t
magazynu	m a g a z i2 n u
obrazie	o b r a zj e
było	b i2 w o
uwolnił	u v o l n i w
sierpnia	sj e r p n i a
gangów	g a n g u v
okrucieństwa	o k r u tsj e n~ s t f a
swojego	s v o j e g o
tabelki	t a b e l k i
oznacza	o z n a tS a
kamienny	k a m i e n n i2
przyrost	p S i2 r o s t
wysoko	v i2 s o k o
kawę	k a v e
peace	p e a c e
zbyt	z b i2 t
spełnione	s p e w n i o n e
łzy	w z i2
je	j e
lewego	l e v e g o
da	d a
wpadają	v p a d a j oc5
otwarci	o t f a r tsj i
zrozumieliśmy	z r o z u m i e l j sj m i2
ideały	i d e a w i2
zmartwychwstanie	z m a r t f i2 h v s t a n i e
watch	v a t h
wąwozy	v oc5 v o z i2
spłodzili	s p w o dzj i l j
opór	o p u r
trzy	t S i2
ku	k u
lokomocji	l o k o m o c j i
pieśń	p i e sj n~
wykorzystywany	v i2 k o Z i2 s t i2 v a n i2
roli	r o l j
czasem	tS a s e m
rozpaczy	r o z p a tS i2
postanowiło	p o s t a n o v i w o
wadze	v a dz e
udostępniają	u d o s t eo5 p n i a j oc5
kobiety	k o b i e t i2
zdjęcia	z d j eo5 tsj a
cosmo	c o s m o
mięśnie	m i eo5 sj n i e
zamku	z a m k u
misternie	m i s t e r n i e
obu	o b u
współczesnej	v s p u w tS e s n e j
1998	v i eo5 t eo5 tsj e
wszystkie	v S i2 s t k i e
znajomym	z n a j o m i2 m
obcy	o b c i2
żony	Z o n i2
pstryk	p s t r i2 k
jeśli	j e sj l j
byt	b i2 t
wręcz	v r eo5 tS
rozstawionymi	r o z s t a v i o n i2 m i
zbladł	z b l a d w
autentyczności	a u t e n t i2 tS n o sj tsj i
słuchać	s w u h a tsj
lekcja	l e k c j a
gronie	g r o n i e
czującej	tS u j oc5 c e j
króla	k r u l a
doskonalić	d o s k o n a l j tsj
cesarzowi	c e s a Z o v i
niego	n i e g o
wokół	v o k u w
ręką	r eo5 k oc5
niezwyciężonego	n i e z v i2 tsj eo5 Z o n e g o
zatrudnionemu	z a t r u d n i o n e m u
napady	n a p a d i2
każda	k a Z d a
zwiedzić	z v i e dzj i tsj
wpisane	v p i s a n e
kiedykolwiek	k i e d i2 k o l v i e k
prawda	p r a v d a
ułatwi	u w a t f i
różne	r u Z n e
odtąd	o d t oc5 d
g	g
wojownik	v o j o v n i k
przeoczy	p S e o tS i2
metodę	m e t o d e
oparcie	o p a r tsj e
mam	m a m
gel	g e l
przemieniła	p S e m i e n i w a
taką	t a k oc5
młoda	m w o d a
piątą	p i oc5 t oc5
sebastiana	s e b a s t j a n a
racjonalnie	r a c j o n a l n i e
okolicznościach	o k o l j tS n o sj tsj a h
spraw	s p r a v
shi-king	s h j k i n g
przypomina	p S i2 p o m i n a
zgadzam	z g a dz a m
kolacja	k o l a c j a
należałoby	n a l e Z a w o b i2
hohenlohe	h o h e n l o h e
dziennikarzom	dzj e n n i k a Z o m
francuzem	f r a n c u z e m
podszczuje	p o d S tS u j e
oka	o k a
litości	l j t o sj tsj i
mową	m o v oc5
rękach	r eo5 k a h
postać	p o s t a tsj
dantego	d a n t e g o
głową	g w o v oc5
końca	k o n~ c a
taka	t a k a
jedynaczką	j e d i2 n a tS k oc5
plecy	p l e c i2
rozmiarów	r o z m i a r u v
szybko	S i2 b k o
nawyki	n a v i2 k i
technikami	t e h n i k a m i
rzucić	Z u tsj i tsj
sklepie	s k l e p i e
powiedzą	p o v i e dz oc5
majów-	m a j u v
oddać	o d d a tsj
kończy	k o n~ tS i2
wróć	v r u tsj
katastroficznie	k a t a s t r o f i tS n i e
zmierzch	z m i e Z h
pojęcia	p o j eo5 tsj a
urodzony	u r o dz o n i2
się	sj i e
ukaże	u k a Z e
przedstawienie	p S e d s t a v i e n i e
ruskina	r u s k i n a
dopuszcza	d o p u S tS a
ofierze	o f i e Z e
director	d j r e c t o r
skakać	s k a k a tsj
czuły	tS u w i2
tabliczkę	t a b l j tS k e
głęboką	g w eo5 b o k oc5
dziobie	dzj o b i e
modlitwę	m o d l j t f e
p	p
pojąwszy	p o j oc5 v S i2
dreamweavera-	d r e a m v e a f e r a e
mamy	m a m i2
ryju	r i2 j u
przekroczone	p S e k r o tS o n e
wystarczająca	v i2 s t a r tS a j oc5 c a
zapewnia	z a p e v n i a
myślisz	m i2 sj l j S
skazany	s k a z a n i2
przyciągniesz	p S i2 tsj oc5 g n i e S
korzyści	k o Z i2 sj tsj i
cieni	tsj e n i
przeciętny	p S e tsj eo5 t n i2
sobą	s o b oc5
elle	e l l e
pieniędzy	p i e n i eo5 dz i2
wypączkowywanie	v i2 p oc5 tS k o v i2 v a n i e
leciały	l e tsj a w i2
duszy	d u S i2
wiejącego	v i e j oc5 c e g o
organizm	o r g a n i z m
drgające	d r g a j oc5 c e
śmieci	sj m i e tsj i
los	l o s
arcydzieł	a r c i2 dzj e w
zwłok	z v w o k
narasta	n a r a s t a
rozpoznaje	r o z p o z n a j e
stosunki	s t o s u n k i
powiedzenia	p o v i e dz e n i a
obecność	o b e c n o sj tsj
dawidowi	d a v i d o v i
50-metrowy	p i t e m e t r o v i2
uczą	u tS oc5
budzą	b u dz oc5
wpływają	v p w i2 v a j oc5
przeklęta	p S e k l eo5 t a
okazuje	o k a z u j e
ćwiczenie	tsj v i tS e n i e
nimfomania	n i m f o m a n i a
śmiertelnika	sj m i e r t e l n i k a
bezradność	b e z r a d n o sj tsj
potrzebne	p o t S e b n e
stało	s t a w o
tragedii	t r a g e d j i
kobietą	k o b i e t oc5
użyciem	u Z i2 tsj e m
wiku	v i k u
dodatku	d o d a t k u
l	l
boga	b o g a
wiedzieć	v i e dzj e tsj
grekom	g r e k o m
menda	m e n d a
wynika	v i2 n i k a
milczeć	m i l tS e tsj
góry	g u r i2
skierował	s k i e r o v a w
dwadzieścia	d v a dzj e sj tsj a
podatny	p o d a t n i2
zmiany	z m i a n i2
ostatnich	o s t a t n i h
napotkałeś	n a p o t k a w e sj
poświęca	p o sj v i eo5 c a
mięsa	m i eo5 s a
niecnym	n i e c n i2 m
rozstania	r o z s t a n i a
starej	s t a r e j
120	s t o d t
odręcznie	o d r eo5 tS n i e
odkryć	o t k r i2 tsj
matko	m a t k o
obmyty	o b m i2 t i2
pragniemy	p r a g n i e m i2
rozwiązanie	r o z v i oc5 z a n i e
układem	u k w a d e m
transclucide	t r a n s c l u tsj i d e
firmach	f i r m a h
wierzący	v i e Z oc5 c i2
tamtych	t a m t i2 h
małżeństwo	m a w Z e n~ s t f o
badaczy	b a d a tS i2
poradnik	p o r a d n i k
8	e
kraju	k r a j u
programów	p r o g r a m u v
groźne	g r o zj n e
miedzi	m i e dzj i
zwyczaju	z v i2 tS a j u
kałem	k a w e m
ludzkich	l u dz k i h
doceniony	d o c e n i o n i2
postanowił	p o s t a n o v i w
skórach	s k u r a h
pogoni	p o g o n i
arystoteles	a r i2 s t o t e l e s
książę	k tsj oc5 Z e
poznawanie	p o z n a v a n i e
bolesława	b o l e s w a v a
jasna	j a s n a
podłogi	p o d w o g i
dziadkiem	dzj a t k i e m
popędem	p o p eo5 d e m
narzędzia	n a Z eo5 dzj a
dłoni	d w o n i
lustro	l u s t r o
wodę	v o d e
naszej	n a S e j
oryginalny	o r i2 g i n a l n i2
zawodowca-	z a v o d o v c a e
policzków	p o l j tS k u v
listy	l j s t i2
bramy	b r a m i2
różnią	r u Z n i oc5
lata	l a t a
chaotyczna	h a o t i2 tS n a
szpecące	S p e c oc5 c e
oporni	o p o r n i
spotyka	s p o t i2 k a
szczęściu	S tS eo5 sj tsj u
mężczyzn	m eo5 Z tS i2 z n
pozostałe	p o z o s t a w e
drużyny	d r u Z i2 n i2
muzycznie	m u z i2 tS n i e
zbuntowaną	z b u n t o v a n oc5
zgromadzone	z g r o m a dz o n e
oczy	o tS i2
dali	d a l j
długi	d w u g i
wypuściła	v i2 p u sj tsj i w a
de	d e
cierpię	tsj e r p i e
deskę	d e s k e
byle	b i2 l e
przetrwa	p S e t r v a
pustkowia	p u s t k o v i a
zmartwychwstania	z m a r t f i2 h v s t a n i a
nawet	n a v e t
prezydenta	p r e z i2 d e n t a
stronach	s t r o n a h
donosy-	d o n o s i2
spodziewajmy	s p o dzj e v a j m i2
doskonale	d o s k o n a l e
trud	t r u d
rozległej	r o z l e g w e j
znamię	z n a m i e
dość	d o sj tsj
wyodrębnił	v i2 o d r eo5 b n i w
najmniej	n a j m n i e j
trupiego	t r u p i e g o
żalów	Z a l u v
punkty	p u n k t i2
porcie	p o r tsj e
epoki	e p o k i
pryncypialność	p r i2 n c i2 p i a l n o sj tsj
alkoholu-	a l k o h o l u
pomiędzy	p o m i eo5 dz i2
wybranego	v i2 b r a n e g o
zbawić	z b a v i tsj
sprowadzona	s p r o v a dz o n a
niebyt	n i e b i2 t
ręku	r eo5 k u
trzewikami	t S e v i k a m i
rybackie	r i2 b a c k i e
wszystkę	v S i2 s t k e
albert	a l b e r t
zachowuje	z a h o v u j e
walecznie	v a l e tS n i e
przyznam	p S i2 z n a m
dzisiejszej	dzj i sj e j S e j
kijem	k i j e m
ułomna	u w o m n a
przechwalają	p S e h v a l a j oc5
funkcje	f u n k c j e
świadomy	sj v i a d o m i2
san	s a n
książęcej	k tsj oc5 Z eo5 c e j
wizjoner	v i z j o n e r
samym	s a m i2 m
ekspansywne	e k s p a n s i2 v n e
wypełnieniem	v i2 p e w n i e n i e m
cennych	c e n n i2 h
oddziaływania	o d dzj a w i2 v a n i a
węgły	v eo5 g w i2
zmywanie	z m i2 v a n i e
zyskasz	z i2 s k a S
sprawiać	s p r a v i a tsj
trudności	t r u d n o sj tsj i
ideału	i d e a w u
spoglądam	s p o g l oc5 d a m
ulu	u l u
blizny	b l j z n i2
komputerze	k o m p u t e Z e
rozpusty	r o z p u s t i2
przysiadł	p S i2 tsj a d w
nocach	n o c a h
życie	Z i2 tsj e
chłopi-	h w o p e e
otwartym	o t f a r t i2 m
nieograniczone	n i e o g r a n i tS o n e
pozycji	p o z i2 c j i
tonacji	t o n a c j i
burzycielce	b u Z i2 tsj e l c e
gest	g e s t
dawnych	d a v n i2 h
naukowych	n a u k o v i2 h
okładki	o k w a t k i
sukcesem	s u k c e s e m
samych	s a m i2 h
określa	o k r e sj l a
polskiej	p o l s k i e j
wprawiając	v p r a v i a j oc5 c
tłumaczenie	t w u m a tS e n i e
y	i2
łączności	w oc5 tS n o sj tsj i
ulegniesz	u l e g n i e S
miłe	m i w e
znieść	z n i e sj tsj
uśmiechnął	u sj m i e h n oc5 w
ciemnościach	tsj e m n o sj tsj a h
spojrzeć	s p o j Z e tsj
bazyliszka	b a z i2 l j S k a
dpi	d p i
uprawiają	u p r a v i a j oc5
księgi	k sj eo5 g i
in	i n
którym	k t u r i2 m
wrogów	v r o g u v
sam	s a m
dziesiątego	dzj e tsj oc5 t e g o
niemce	n i e m c e
udzielają	u dzj e l a j oc5
głowę	g w o v e
sy	s i2
pozbawić	p o z b a v i tsj
woda	v o d a
dzisiejszych	dzj i sj e j S i2 h
zaopatrując	z a o p a t r u j oc5 c
przyjemności-	p S i2 j e m n o sj tsj e
kormorany	k o r m o r a n i2
kontakty	k o n t a k t i2
ono	o n o
cara	c a r a
pooperacyjnej	p o o p e r a c i2 j n e j
przekonywał	p S e k o n i2 v a w
zwalczanego	z v a l tS a n e g o
uniwersalnym	u n i v e r s a l n i2 m
brak	b r a k
starają	s t a r a j oc5
nieboską	n i e b o s k oc5
cóż	c u S
chromosomalnie	h r o m o s o m a l n i e
prawego	p r a v e g o
józefa	j u z e f a
pojednanego	p o j e d n a n e g o
swoimi	s v o i m i
okna	o k n a
zajmuje	z a j m u j e
ze	z e
wówczas	v u v tS a s
podbija	p o d b i j a
wypływały"-	v i2 p w i2 v a w i2
pożyczyłem	p o Z i2 tS i2 w e m
animacji	a n i m a c j i
wypadłaś	v i2 p a d w a sj
kilkoma	k i l k o m a
szybowców	S i2 b o v c u v
duchową	d u h o v oc5
nieprzyjaciół	n i e p S i2 j a tsj u w
została	z o s t a w a
psalm	p s a l m
wyrwał	v i2 r v a w
źródłem	zj r u d w e m
mieczach	m i e tS a h
niebiańska	n i e b i a n~ s k a
zamykał	z a m i2 k a w
można	m o Z n a
utwór	u t f u r
wspólnym	v s p u l n i2 m
aniołowie	a n i o w o v i e
absurdalna	a b s u r d a l n a
spacerów	s p a c e r u v
katarzyna	k a t a Z i2 n a
franco	f r a n c o
poznanego	p o z n a n e g o
świata	sj v i a t a
lancer	l a n c e r
stań	s t a n~
modlitwą	m o d l j t f oc5
pierś	p i e r sj
reprezentowała	r e p r e z e n t o v a w a
apostolskiego	a p o s t o l s k i e g o
rybka:-	r i2 b k a e
dostojewskiego	d o s t o j e v s k i e g o
wcześniej	v tS e sj n i e j
szczera	S tS e r a
seksualnie	s e k s u a l n i e
upiłem	u p i w e m
bogarodzicy	b o g a r o dzj i c i2
k	k
ponoć	p o n o tsj
niż	n i S
przyrządzić	p S i2 Z oc5 dzj i tsj
niepotrzebnych	n i e p o t S e b n i2 h
rodu	r o d u
słynne	s w i2 n n e
wydarzeniem	v i2 d a Z e n i e m
źrenicę	zj r e n i c e
arcydziełami	a r c i2 dzj e w a m i
troszkę	t r o S k e
bawi	b a v i
zuchwała	z u h v a w a
ty	t i2
ministerstwa	m i n i s t e r s t f a
wcześniejszego	v tS e sj n i e j S e g o
dałeś	d a w e sj
dniach	d n i a h
jałowca	j a w o v c a
nauczysz	n a u tS i2 S
grzmoty	g Z m o t i2
końcowym	k o n~ c o v i2 m
lauder	l a u d e r
16	s t tsj e
wyłania	v i2 w a n i a
pora	p o r a
bezstronni	b e z s t r o n n i
sklepieniem	s k l e p i e n i e m
straszliwszy	s t r a S l j v S i2
laty	l a t i2
nikt	n i k t
wszechmogącym	v S e h m o g oc5 c i2 m
woli	v o l j
pewnie	p e v n i e
zainteresował	z a i n t e r e s o v a w
zmarł	z m a r w
przyjął	p S i2 j oc5 w
odbierana	o d b i e r a n a
głośników-satelitów	g w o sj n i k u v s a t e l j t u v
moralności	m o r a l n o sj tsj i
prorodzinne	p r o r o dzj i n n e
niemieckie	n i e m i e c k i e
drabinkę	d r a b i n k e
staje	s t a j e
współczesnym	v s p u w tS e s n i2 m
doprowadzających	d o p r o v a dz a j oc5 c i2 h
ażeby	a Z e b i2
horrory	h o r r o r i2
coelho	c o e l h o
zachowanie	z a h o v a n i e
mógł	m u g w
jakichś	j a k i h sj
wyleczy	v i2 l e tS i2
masywnych	m a s i2 v n i2 h
dunin	d u n i n
przed	p S e d
informację	i n f o r m a c j e
rozbudował	r o z b u d o v a w
paskudna	p a s k u d n a
przestajemy	p S e s t a j e m i2
najlepszym	n a j l e p S i2 m
próbowałeś	p r u b o v a w e sj
on-the-loose	o n t h e l o o s e
nury	n u r i2
tradycyjnie-	t r a d i2 c i2 j n i e e
pracowity	p r a c o v i t i2
twórca	t f u r c a
villa	f i l l a
powojennej	p o v o j e n n e j
mignęło	m i g n eo5 w o
cząstki	tS oc5 s t k i
mogła	m o g w a
zaczynają	z a tS i2 n a j oc5
odmienne	o d m i e n n e
krwawej	k r v a v e j
warszawski	v a r S a v s k i
prawa	p r a v a
naszego	n a S e g o
światowej	sj v i a t o v e j
sobą-	s o b oc5 e
światem	sj v i a t e m
stratofortress	s t r a t o f o r t r e S
wyraźniej	v i2 r a zj n i e j
milion	m i l j o n
dodania	d o d a n i a
artystą	a r t i2 s t oc5
shimmering	s h j m m e r j n g
my	m i2
tworem	t f o r e m
udowodnił	u d o v o d n i w
przemkną	p S e m k n oc5
trudne	t r u d n e
modlimy	m o d l j m i2
wytrzeźwieję	v i2 t S e zj v i e j e
wychodzi	v i2 h o dzj i
nawyków	n a v i2 k u v
wiekach	v i e k a h
bruno	b r u n o
zawiedzionej	z a v i e dzj o n e j
prawicy	p r a v i c i2
produkujących	p r o d u k u j oc5 c i2 h
napisać	n a p i s a tsj
łupy	w u p i2
niemożliwą	n i e m o Z l j v oc5
potrzeby	p o t S e b i2
głównej	g w u v n e j
wersje	v e r s j e
łupem	w u p e m
sebastian	s e b a s t j a n
głęboko	g w eo5 b o k o
wołanie	v o w a n i e
świętości	sj v i eo5 t o sj tsj i
wojciecha	v o j tsj e h a
szkołą	S k o w oc5
ksiąg	k tsj oc5 g
podróży	p o d r u Z i2
badacz	b a d a tS
powierzchowność	p o v i e Z h o v n o sj tsj
torturować	t o r t u r o v a tsj
uobecnia	u o b e c n i a
zmarłych	z m a r w i2 h
żyją	Z i2 j oc5
uderzał	u d e Z a w
niewyobrażalne	n i e v i2 o b r a Z a l n e
podejrzewać	p o d e j Z e v a tsj
dynamikę	d i2 n a m i k e
zabójczą	z a b u j tS oc5
ponad	p o n a d
jakoś	j a k o sj
przepadłego	p S e p a d w e g o
opłaca	o p w a c a
leszczyny	l e S tS i2 n i2
cel	c e l
wobec	v o b e c
schachingera	s h a h j n g e r a
układałem	u k w a d a w e m
dawna	d a v n a
wstydzi	v s t i2 dzj i
stalina	s t a l j n a
machiavelli	m a h j a f e l l j
zniszczył	z n i S tS i2 w
koniec-	k o n i e c e
odsuwają	o d s u v a j oc5
stoi	s t o i
zbudujemy	z b u d u j e m i2
bólem	b u l e m
chwyć	h v i2 tsj
obszar	o b S a r
stronie	s t r o n i e
nich	n i h
zabezpieczyć	z a b e z p i e tS i2 tsj
ogłoszeń	o g w o S e n~
zalaniem	z a l a n i e m
królestwo	k r u l e s t f o
młodocianej	m w o d o tsj a n e j
błąd	b w oc5 d
powiedział	p o v i e dzj a w
kontrolę	k o n t r o l e
tomasz	t o m a S
bogu	b o g u
wskazówka	v s k a z u v k a
ujęcia	u j eo5 tsj a
fosy	f o s i2
mocą	m o c oc5
wierzą	v i e Z oc5
predefiniowanych	p r e d e f i n i o v a n i2 h
obnażony	o b n a Z o n i2
jaką	j a k oc5
kontroli	k o n t r o l j
kubuś	k u b u sj
norek	n o r e k
otwarta	o t f a r t a
negatywne	n e g a t i2 v n e
m	m
szlachtę	S l a h t e
włochatą	v w o h a t oc5
do	d o
znajdziesz	z n a j dzj e S
tys	t i2 s
złotego	z w o t e g o
programie	p r o g r a m i e
wpływa	v p w i2 v a
mogę	m o g e
pyłku	p i2 w k u
rogu	r o g u
przetoczyć	p S e t o tS i2 tsj
gospodynią	g o s p o d i2 n i oc5
powstaje	p o v s t a j e
turyngii	t u r i2 n g i i
przepowiadać	p S e p o v i a d a tsj
chelsea	h e l s e a
błędnik	b w eo5 d n i k
prezydentem	p r e z i2 d e n t e m
nieobecność	n i e o b e c n o sj tsj
pielęgnacji	p i e l eo5 g n a c j i
wersja	v e r s j a
naprawdę	n a p r a v d e
przyjaciół	p S i2 j a tsj u w
powinniśmy	p o v i n n i sj m i2
wykształcenie	v i2 k S t a w c e n i e
falować	f a l o v a tsj
żywi	Z i2 v i
goethe	g o e t h e
ciemnoczerwonym	tsj e m n o tS e r v o n i2 m
sytuacje	s i2 t u a c j e
martwe	m a r t f e
osobą	o s o b oc5
jest	j e s t
miała	m i a w a
przyszłości	p S i2 S w o sj tsj i
zechcę	z e h c e
swoją	s v o j oc5
piekło	p i e k w o
pokorny	p o k o r n i2
typowo	t i2 p o v o
rainer	r a i n e r
silniejszy	sj i l n i e j S i2
przykrości	p S i2 k r o sj tsj i
tekst	t e k s t
cichy	tsj i h i2
waszego	v a S e g o
zdjęcie	z d j eo5 tsj e
władzy	v w a dz i2
okazali	o k a z a l j
przekonaj	p S e k o n a j
biorę	b i o r e
diamentów	d j a m e n t u v
sytuacjach	s i2 t u a c j a h
hormony	h o r m o n i2
swój	s v u j
moment	m o m e n t
nicość	n i c o sj tsj
operacja	o p e r a c j a
is	i s
cierpi	tsj e r p i
namagnesowana	n a m a g n e s o v a n a
martwej	m a r t f e j
swego	s v e g o
artysty	a r t i2 s t i2
zanurzonych	z a n u Z o n i2 h
urody	u r o d i2
usytuowany	u s i2 t u o v a n i2
tożsamości	t o Z s a m o sj tsj i
cosmodziewczyny	c o s m o dzj e v tS i2 n i2
zamachowi	z a m a h o v i
rilke	r j l k e
panelu	p a n e l u
niesłychanie	n i e s w i2 h a n i e
zbrodniczą	z b r o d n i tS oc5
stuprocentowa	s t u p r o c e n t o v a
zakręcił	z a k r eo5 tsj i w
użyteczność	u Z i2 t e tS n o sj tsj
aktorstwo	a k t o r s t f o
dwieście	d v i e sj tsj e
raczej	r a tS e j
klamry	k l a m r i2
captif	c a p t j f
ogarnąć	o g a r n oc5 tsj
ogranicza	o g r a n i tS a
brzmiały	b Z m i a w i2
względem	v z g l eo5 d e m
ochroniarze	o h r o n i a Z e
panie	p a n i e
zresztą	z r e S t oc5
milne'a	m i l n e a
teatr	t e a t r
zobaczę	z o b a tS e
znaleźć	z n a l e zj tsj
organy	o r g a n i2
enhanced	e n h a n c e d
genialną	g e n i a l n oc5
wzroku	v z r o k u
szalała	S a l a w a
emocji	e m o c j i
wyłaniają	v i2 w a n i a j oc5
stadionie	s t a d j o n i e
innym	i n n i2 m
naukom	n a u k o m
kogo	k o g o
kilkadziesiąt	k i l k a dzj e tsj oc5 t
zaradzić	z a r a dzj i tsj
pomieszczeń	p o m i e S tS e n~
przejrzał	p S e j Z a w
spokojnie	s p o k o j n i e
sygnałów	s i2 g n a w u v
kochając	k o h a j oc5 c
chętnie	h eo5 t n i e
ucisku	u tsj i s k u
rozpływa	r o z p w i2 v a
skruszony	s k r u S o n i2
kąpielowych	k oc5 p i e l o v i2 h
moje	m o j e
komedia	k o m e d j a
wiatr	v i a t r
samotna	s a m o t n a
obawom	o b a v o m
pożerał	p o Z e r a w
krescencjusz	k r e s c e n c j u S
zdania	z d a n i a
tyrolu	t i2 r o l u
konkretnym	k o n k r e t n i2 m
stare	s t a r e
pełnego	p e w n e g o
grodom	g r o d o m
sprytna	s p r i2 t n a
iwan	i v a n
pochłaniających	p o h w a n i a j oc5 c i2 h
dorobku	d o r o b k u
komornicy	k o m o r n i c i2
latach	l a t a h
przychodniom	p S i2 h o d n i o m
bryłami	b r i2 w a m i
drożynami	d r o Z i2 n a m i
trąbka-	t r oc5 b k a e
prostoty	p r o s t o t i2
popołudnia	p o p o w u d n i a
słowiańskiego	s w o v i a n~ s k i e g o
skinął	s k i n oc5 w
krwawą	k r v a v oc5
istnieć	i s t n i e tsj
istnieje	i s t n i e j e
romansu	r o m a n s u
hitlera-	h j t l e r a e
dolarów	d o l a r u v
płakał-	p w a k a w e
pachnącej	p a h n oc5 c e j
niewyrażalnego	n i e v i2 r a Z a l n e g o
arabski	a r a b s k i
morską	m o r s k oc5
sznureczkami	S n u r e tS k a m i
koziołków	k o zj o w k u v
ludzkość	l u dz k o sj tsj
rozpoczął	r o z p o tS oc5 w
von	f o n
odnośnikiem	o d n o sj n i k i e m
przetrwać	p S e t r v a tsj
odwołaniami	o d v o w a n i a m i
ogromne	o g r o m n e
rozmawiałeś	r o z m a v i a w e sj
zwalany	z v a l a n i2
molestowani	m o l e s t o v a n i
politycznych	p o l j t i2 tS n i2 h
faktem	f a k t e m
przeżywać	p S e Z i2 v a tsj
potrawach	p o t r a v a h
popijają	p o p i j a j oc5
tour	t o u r
dubbingiem	d u b b i n g i e m
pomyślałam	p o m i2 sj l a w a m
krzyżakom	k S i2 Z a k o m
opcja	o p c j a
umysłu	u m i2 s w u
choroby	h o r o b i2
moim	m o i m
ona	o n a
wszystkimi	v S i2 s t k i m i
głogowa	g w o g o v a
przyrostowe	p S i2 r o s t o v e
postradał	p o s t r a d a w
bezpośrednio	b e z p o sj r e d n i o
czujesz	tS u j e S
postępuje	p o s t eo5 p u j e
prawdzie	p r a v dzj e
grzegorz	g Z e g o S
nazywa	n a z i2 v a
przekazywał	p S e k a z i2 v a w
entuzjastów	e n t u z j a s t u v
którą	k t u r oc5
nazwał	n a z v a w
żona	Z o n a
masowo	m a s o v o
scena	s c e n a
musi	m u sj i
najśw	n a j sj v
kończyć	k o n~ tS i2 tsj
przerwę	p S e r v e
strzemiona	s t S e m i o n a
liczy	l j tS i2
javascript	j a f a s c r j p t
ciekawszy	tsj e k a v S i2
resztę	r e S t e
obliczem	o b l j tS e m
części	tS eo5 sj tsj i
uznanie	u z n a n i e
ścianach	sj tsj a n a h
magda	m a g d a
pogłowia	p o g w o v i a
bogato	b o g a t o
przekonają	p S e k o n a j oc5
niechlubnie	n i e h l u b n i e
musiały	m u tsj a w i2
opiekę	o p i e k e
mitu	m i t u
znalezienia	z n a l e zj e n i a
zapewniają	z a p e v n i a j oc5
telekomunikacji	t e l e k o m u n i k a c j i
przeszkadzał	p S e S k a dz a w
starego	s t a r e g o
niżej	n i Z e j
wpuszczali	v p u S tS a l j
studium	s t u d j u m
zbliżamy	z b l j Z a m i2
osama	o s a m a
co	c o
diamonds	d j a m o n d s
standardowo	s t a n d a r d o v o
szeleśći	S e l e sj tsj i
ojczyźnie	o j tS i2 zj n i e
owym	o v i2 m
jakby	j a k b i2
jakość	j a k o sj tsj
papieski	p a p i e s k i
zabłąkanych	z a b w oc5 k a n i2 h
śmiech	sj m i e h
biurowym	b i u r o v i2 m
swe	s v e
granice	g r a n i c e
łkającego	w k a j oc5 c e g o
opuszczając	o p u S tS a j oc5 c
obojętnością	o b o j eo5 t n o sj tsj oc5
godności	g o d n o sj tsj i
twego	t f e g o
miesiącami	m i e tsj oc5 c a m i
pisali	p i s a l j
pojawiła	p o j a v i w a
moi	m o i
gwardzistami	g v a r dzj i s t a m i
oczami	o tS a m i
dorosłego	d o r o s w e g o
nazwij	n a z v i j
poznał	p o z n a w
skaczących	s k a tS oc5 c i2 h
znacie	z n a tsj e
pomorski	p o m o r s k i
honorowej	h o n o r o v e j
zagrali	z a g r a l j
fucking	f u c k i n g
ostateczna	o s t a t e tS n a
myślom	m i2 sj l o m
religijnej	r e l j g i j n e j
sława	s w a v a
repertuaru	r e p e r t u a r u
takich	t a k i h
nakapał	n a k a p a w
wszelkich	v S e l k i h
strachu	s t r a h u
gwiazdy	g v i a z d i2
któryś	k t u r i2 sj
fantazją	f a n t a z j oc5
wyłoni	v i2 w o n i
dostarczał	d o s t a r tS a w
wytwornego	v i2 t f o r n e g o
4	tS t
23	d S i2
płacisz	p w a tsj i S
makijażystka	m a k i j a Z i2 s t k a
19	s t eo5 tsj
ciasta	tsj a s t a
zagradzały	z a g r a dz a w i2
wyjeżdża	v i2 j e Z dZ a
środkami	sj r o t k a m i
straconego	s t r a c o n e g o
obrotów	o b r o t u v
wpływu	v p w i2 v u
naukowcy	n a u k o v c i2
używają	u Z i2 v a j oc5
pierwsze	p i e r v S e
żadnym	Z a d n i2 m
znowu	z n o v u
akcji	a k c j i
zyskują	z i2 s k u j oc5
wynalazek	v i2 n a l a z e k
jerozolimie-	j e r o z o l j m i e e
ociężale	o tsj eo5 Z a l e
powoływać	p o v o w i2 v a tsj
zegarek	z e g a r e k
para	p a r a
porównuję	p o r u v n u j e
nieustanną	n i e u s t a n n oc5
zaczęło	z a tS eo5 w o
duchowe	d u h o v e
fausta	f a u s t a
święte	sj v i eo5 t e
myślnika	m i2 sj l n i k a
pozornie	p o z o r n i e
brzydka	b Z i2 t k a
trzymaj	t S i2 m a j
obietnice	o b i e t n i c e
kupię	k u p i e
tenisiści	t e n i s i sj tsj i
niewykluczone-	n i e v i2 k l u tS o n e e
chciało	h tsj a w o
słuch	s w u h
telefon	t e l e f o n
wodorostów	v o d o r o s t u v
wojskami	v o j s k a m i
skłonności	s k w o n n o sj tsj i
teatru	t e a t r u
skomplikowanej	s k o m p l j k o v a n e j
ukończony	u k o n~ tS o n i2
utożsamiają	u t o Z s a m i a j oc5
wygasła-	v i2 g a s w a e
afryce	a f r i2 c e
odwiedził	o d v i e dzj i w
garść	g a r sj tsj
odchodzić	o d h o dzj i tsj
pokazuje	p o k a z u j e
pustce	p u s t c e
synów	s i2 n u v
zastąpił	z a s t oc5 p i w
gwarantuje	g v a r a n t u j e
związane	z v i oc5 z a n e
wstrząsnęło	v s t S oc5 s n eo5 w o
niszczą	n i S tS oc5
obiekty	o b i e k t i2
piaski	p i a s k i
pigułkę	p i g u w k e
szczegół	S tS e g u w
powieść	p o v i e sj tsj
potęgę	p o t eo5 g e
ludzi	l u dzj i
szczęśliwej	S tS eo5 sj l j v e j
perspektywom	p e r s p e k t i2 v o m
sypiasz	s i2 p i a S
prawe	p r a v e
królestwa	k r u l e s t f a
chytre	h i2 t r e
pośród	p o sj r u d
idą	i d oc5
prusy	p r u s i2
wyznawca	v i2 z n a v c a
zapłacze	z a p w a tS e
tydzień-	t i2 dzj e n~ e
ekstrawagancji	e k s t r a v a g a n c j i
przyjrzyj	p S i2 j Z i2 j
jakichkolwiek	j a k i h k o l v i e k
narzędzie	n a Z eo5 dzj e
ciasto	tsj a s t o
komputer	k o m p u t e r
kochają	k o h a j oc5
olimpiady	o l j m p i a d i2
pozostają	p o z o s t a j oc5
poznanie	p o z n a n i e
motoryzacja	m o t o r i2 z a c j a
kolorowego	k o l o r o v e g o
zaprezentowałam	z a p r e z e n t o v a w a m
wędrówki	v eo5 d r u v k i
roztacza	r o z t a tS a
uznać	u z n a tsj
facetów	f a c e t u v
oprócz	o p r u tS
roślin	r o sj l j n
loren	l o r e n
romansować	r o m a n s o v a tsj
warunkiem	v a r u n k i e m
pokuty	p o k u t i2
milimetr	m i l j m e t r
młody	m w o d i2
phillippe	p h j l l j p p e
mieszkaniu	m i e S k a n i u
wydaniem	v i2 d a n i e m
pokaże	p o k a Z e
żadne	Z a d n e
bym	b i2 m
diabeł	d j a b e w
rozdzierającego	r o z dzj e r a j oc5 c e g o
traktowane	t r a k t o v a n e
mocarstwo	m o c a r s t f o
zaabsorbowanej	z a a b s o r b o v a n e j
wrzuceniem	v Z u c e n i e m
komputerach	k o m p u t e r a h
wcześniejsze	v tS e sj n i e j S e
inaczej	i n a tS e j
podającą	p o d a j oc5 c oc5
sto	s t o
watteau	v a t t e a u
brzuch	b Z u h
proszę	p r o S e
związków	z v i oc5 z k u v
murów	m u r u v
mną	m n oc5
image	i m a g e
sofoklesa	s o f o k l e s a
tu	t u
wizerunek	v i z e r u n e k
głębokości	g w eo5 b o k o sj tsj i
wielka-	v i e l k a e
zmęczony	z m eo5 tS o n i2
zdanie	z d a n i e
chrapiesz	h r a p i e S
ludzka	l u dz k a
strzaskali	s t S a s k a l j
żegnają	Z e g n a j oc5
graficzne	g r a f i tS n e
posłuszny	p o s w u S n i2
chłop	h w o p
właściwości	v w a sj tsj i v o sj tsj i
sen	s e n
zerwania	z e r v a n i a
plotzke	p l o t z k e
oto	o t o
ostatnia	o s t a t n i a
uda	u d a
umiał	u m i a w
pannie	p a n n i e
stosowane	s t o s o v a n e
skraju	s k r a j u
makijaż	m a k i j a S
przewodnik	p S e v o d n i k
olejków	o l e j k u v
wyjściowego	v i2 j sj tsj o v e g o
litych	l j t i2 h
podjęły	p o d j eo5 w i2
młodsze	m w o d S e
dopiero	d o p i e r o
podejrzałem	p o d e j Z a w e m
przeszkadza	p S e S k a dz a
klątwę	k l oc5 t f e
ognista	o g n i s t a
załatwiłem	z a w a t f i w e m
tradycja	t r a d i2 c j a
kocha	k o h a
znakami	z n a k a m i
doskonałego	d o s k o n a w e g o
niezliczone	n i e z l j tS o n e
ogłosił	o g w o sj i w
tanga	t a n g a
zarazem	z a r a z e m
382	S i2 o sj d
ogólny	o g u l n i2
widzisz	v i dzj i S
ciemności	tsj e m n o sj tsj i
artystycznych	a r t i2 s t i2 tS n i2 h
wyglądacie	v i2 g l oc5 d a tsj e
chwilę	h v i l e
odpowiedzi	o d p o v i e dzj i
szczególne	S tS e g u l n e
lewą	l e v oc5
zimno	zj i m n o
zdaniem	z d a n i e m
zasypiam	z a s i2 p i a m
łaskawą	w a s k a v oc5
całkowite	c a w k o v i t e
podglądać	p o d g l oc5 d a tsj
prostą	p r o s t oc5
misiuro	m i sj i u r o
gęstnieje	g eo5 s t n i e j e
rozpacz	r o z p a tS
polityki	p o l j t i2 k i
skupienia	s k u p i e n i a
tworzenia	t f o Z e n i a
dawid	d a v i d
odczuwa	o d tS u v a
otulił	o t u l j w
wziąć	v zj oc5 tsj
rzeczywiście	Z e tS i2 v i sj tsj e
fasady	f a s a d i2
minutach	m i n u t a h
obronić	o b r o n i tsj
chodził	h o dzj i w
międzyludzkie	m i eo5 dz i2 l u dz k i e
niemiara	n i e m i a r a
niosące	n i o s oc5 c e
barw	b a r v
rewolucji	r e v o l u c j i
bezsensownej	b e z s e n s o v n e j
zawieść	z a v i e sj tsj
oddali	o d d a l j
1999	v i eo5 t eo5 tsj eo5 tsj
imprezy	i m p r e z i2
wodzie	v o dzj e
latają	l a t a j oc5
indywidualnych	i n d i2 v i d u a l n i2 h
zamówić	z a m u v i tsj
wie	v i e
poczuła	p o tS u w a
klawisz	k l a v i S
obiecujące	o b i e c u j oc5 c e
rozkrzyżowanymi	r o z k S i2 Z o v a n i2 m i
wracała	v r a c a w a
wszelakim	v S e l a k i m
ten	t e n
horyzonty	h o r i2 z o n t i2
powiedziane	p o v i e dzj a n e
rozważamy	r o z v a Z a m i2
50-metre	p i t m e t r e
wyznana	v i2 z n a n a
izby	i z b i2
wyraźnie	v i2 r a zj n i e
pozwalającym	p o z v a l a j oc5 c i2 m
ogarniętej	o g a r n i eo5 t e j
liturgiii	l j t u r g i i i
zaletą	z a l e t oc5
chama	h a m a
naszych	n a S i2 h
niewygód	n i e v i2 g u d
pierwszej	p i e r v S e j
obliczu	o b l j tS u
ale	a l e
słuchacze	s w u h a tS e
rodziny	r o dzj i n i2
dociera	d o tsj e r a
bestselleru	b e s t s e l l e r u
epoce	e p o c e
picie	p i tsj e
depresję	d e p r e s j e
siedział	sj e dzj a w
długości	d w u g o sj tsj i
lepiej-	l e p i e j e
stanowią	s t a n o v i oc5
wcale	v c a l e
majątkowych	m a j oc5 t k o v i2 h
śmierć-	sj m i e r tsj e
skórę	s k u r e
wolałabym	v o l a w a b i2 m
agitacja	a g i t a c j a
utratą	u t r a t oc5
sartre	s a r t r e
otwiera	o t f i e r a
usypano	u s i2 p a n o
wydartych	v i2 d a r t i2 h
kiełpie	k i e w p i e
sternika	s t e r n i k a
miał	m i a w
niekiedy	n i e k i e d i2
pirat	p i r a t
idziemy	i dzj e m i2
szacuje	S a c u j e
spełnić	s p e w n i tsj
ja-	j a e
kocham	k o h a m
włosy	v w o s i2
wymagają	v i2 m a g a j oc5
jesteśmy	j e s t e sj m i2
rozumem	r o z u m e m
modne	m o d n e
talentu	t a l e n t u
marie	m a r j e
płacz	p w a tS
dwory	d v o r i2
ktoś	k t o sj
zupy	z u p i2
krokodylek	k r o k o d i2 l e k
męskie-	m eo5 s k i e e
fiodora	f i o d o r a
niweczyły	n i v e tS i2 w i2
albo	a l b o
symbole	s i2 m b o l e
każdego	k a Z d e g o
zrozumiałe	z r o z u m i a w e
smutek	s m u t e k
wyobraźni	v i2 o b r a zj n i
znalazł	z n a l a z w
pozbawioną	p o z b a v i o n oc5
nieskończoną	n i e s k o n~ tS o n oc5
spojrzeniem	s p o j Z e n i e m
chorobę	h o r o b e
muzyce	m u z i2 c e
spotkanie	s p o t k a n i e
nasza	n a S a
go	g o
drżała	d r Z a w a
rozłożony	r o z w o Z o n i2
amerykance	a m e r i2 k a n c e
pisarską	p i s a r s k oc5
zawód	z a v u d
idealnie	i d e a l n i e
obmierzły	o b m i e Z w i2
żel	Z e l
zwiększy	z v i eo5 k S i2
między	m i eo5 dz i2
indziej	i n dzj e j
obfitość	o b f i t o sj tsj
zauważyłem	z a u v a Z i2 w e m
stała	s t a w a
zaśpiewają	z a sj p i e v a j oc5
pragnie	p r a g n i e
sterowania	s t e r o v a n i a
nośnikiem	n o sj n i k i e m
wyrasta	v i2 r a s t a
najgłośniejszym	n a j g w o sj n i e j S i2 m
wymijającą	v i2 m i j a j oc5 c oc5
wystarczył	v i2 s t a r tS i2 w
wesprzeć	v e s p S e tsj
opadły	o p a d w i2
blask	b l a s k
martwą	m a r t f oc5
jadło	j a d w o
matematycznej	m a t e m a t i2 tS n e j
naszą	n a S oc5
gównem	g u v n e m
niepogrzebane	n i e p o g Z e b a n e
la	l a
zdań	z d a n~
dodaj	d o d a j
głębiej	g w eo5 b i e j
zabłysnąć	z a b w i2 s n oc5 tsj
polifoniczne	p o l j f o n i tS n e
zaplanowanego	z a p l a n o v a n e g o
jezus	j e z u s
chełmna	h e w m n a
prawideł	p r a v i d e w
użytkowników	u Z i2 t k o v n i k u v
żyć	Z i2 tsj
byłbym	b i2 w b i2 m
mieszankę	m i e S a n k e
ilością	i l o sj tsj oc5
karmy	k a r m i2
postanowienia	p o s t a n o v i e n i a
poznawać	p o z n a v a tsj
wszystkim	v S i2 s t k i m
insygnia	i n s i2 g n i a
odwet-	o d v e t
modlitwa	m o d l j t f a
dźwięk	dzj v i eo5 k
bezpiecznie	b e z p i e tS n i e
wdzierała	v dzj e r a w a
kapeluszy	k a p e l u S i2
rozpoznać	r o z p o z n a tsj
drzwi	d Z v i
miłą	m i w oc5
rolników	r o l n i k u v
spektakl	s p e k t a k l
ciemnością	tsj e m n o sj tsj oc5
dlatego	d l a t e g o
pytanie	p i2 t a n i e
pół	p u w
wcielić	v tsj e l j tsj
najczęściej	n a j tS eo5 sj tsj e j
nawozem	n a v o z e m
daje	d a j e
15	s t n tsj
wyposażonych	v i2 p o s a Z o n i2 h
tworzyć	t f o Z i2 tsj
niemożliwe	n i e m o Z l j v e
tańcujące	t a n~ c u j oc5 c e
początek	p o tS oc5 t e k
wjazd	v j a z d
bożych	b o Z i2 h
trzynastego	t S i2 n a s t e g o
samotności	s a m o t n o sj tsj i
cia	tsj a
sekrety	s e k r e t i2
ciekawą	tsj e k a v oc5
rozmaitości	r o z m a i t o sj tsj i
innych	i n n i2 h
nigdzie	n i g dzj e
wes	v e s
lustrze	l u s t S e
nagle	n a g l e
we	v e
wyrazem	v i2 r a z e m
osiągnę	o tsj oc5 g n e
kultury	k u l t u r i2
l'oreal	l o r e a l
państwowej	p a n~ s t f o v e j
wariant	v a r j a n t
fragonarda	f r a g o n a r d a
kariera	k a r j e r a
wroga	v r o g a
aktualnym	a k t u a l n i2 m
piszczel	p i S tS e l
udźwignie	u dzj v i g n i e
2,3	d S i2
wprost	v p r o s t
przyszłość	p S i2 S w o sj tsj
zdmuchnąć	z d m u h n oc5 tsj
niewielkich	n i e v i e l k i h
niezapomniane	n i e z a p o m n i a n e
kosmosu	k o s m o s u
ciekawa	tsj e k a v a
ukradkiem	u k r a t k i e m
broń	b r o n~
17	s t e
chrztu	h Z t u
ostępów	o s t eo5 p u v
doświadczony	d o sj v i a d tS o n i2
adwokatem	a d v o k a t e m
podnosząca	p o d n o S oc5 c a
wiedzą	v i e dz oc5
scenie	s c e n i e
efekt	e f e k t
tylko	t i2 l k o
proste	p r o s t e
zaczął	z a tS oc5 w
św	sj v
zostaje	z o s t a j e
musiałem	m u tsj a w e m
wygrywała	v i2 g r i2 v a w a
operuje	o p e r u j e
krainę	k r a i n e
walki	v a l k i
oblężeniach	o b l eo5 Z e n i a h
historii	h j s t o r j i
wygnieciesz	v i2 g n i e tsj e S
centralny	c e n t r a l n i2
drżące	d r Z oc5 c e
krwi	k r v i
słońca	s w o n~ c a
adaptacja	a d a p t a c j a
mullins	m u l l j n s
scenografię	s c e n o g r a f i e
chemiczny	h e m i tS n i2
związku	z v i oc5 z k u
zauważ	z a u v a S
uśmiechu	u sj m i e h u
wszechświatów	v S e h sj v i a t u v
przydatne	p S i2 d a t n e
wykazały	v i2 k a z a w i2
gazetą	g a z e t oc5
sieczkowska	sj e tS k o v s k a
niebycie	n i e b i2 tsj e
chichen	h j h e n
zadaniom	z a d a n i o m
stan	s t a n
niby	n i b i2
sztuką	S t u k oc5
bogów	b o g u v
przypadkowych	p S i2 p a t k o v i2 h
interesować	i n t e r e s o v a tsj
bóg	b u g
pochówku	p o h u v k u
wypiera	v i2 p i e r a
włączona	v w oc5 tS o n a
duma	d u m a
pastować	p a s t o v a tsj
zwykłego	z v i2 k w e g o
sprawom	s p r a v o m
użyła	u Z i2 w a
przetargi	p S e t a r g i
wagę	v a g e
radosną	r a d o s n oc5
wydawały	v i2 d a v a w i2
brzydkie	b Z i2 t k i e
trzymać	t S i2 m a tsj
łamać	w a m a tsj
widok	v i d o k
znakiem	z n a k i e m
postawienie	p o s t a v i e n i e
sądem	s oc5 d e m
wywlekli	v i2 v l e k l j
ii	i i
królewski	k r u l e v s k i
nadawało	n a d a v a w o
pyszne	p i2 S n e
podbity	p o d b i t i2
życiu	Z i2 tsj u
obiektywny	o b i e k t i2 v n i2
przemyślną	p S e m i2 sj l n oc5
kolejną	k o l e j n oc5
spodziewasz	s p o dzj e v a S
ręka	r eo5 k a
śnisz	sj n i S
arystokrata	a r i2 s t o k r a t a
nadużywania	n a d u Z i2 v a n i a
rozwagę	r o z v a g e
radości	r a d o sj tsj i
kompleksu	k o m p l e k s u
jednozdaniowej	j e d n o z d a n i o v e j
obraz	o b r a z
powtarzanie	p o v t a Z a n i e
zwierzęcą	z v i e Z eo5 c oc5
rozbiegli	r o z b i e g l j
pastelowej	p a s t e l o v e j
mieć	m i e tsj
wzmógł	v z m u g w
stu	s t u
zamianę	z a m i a n e
piękną	p i eo5 k n oc5
tyran	t i2 r a n
bułhakowa	b u w h a k o v a
wszak	v S a k
kroki	k r o k i
identyczna	i d e n t i2 tS n a
współpracowali	v s p u w p r a c o v a l j
nowej	n o v e j
wojtku	v o j t k u
zaszczepiać	z a S tS e p i a tsj
pewni	p e v n i
wypadku	v i2 p a t k u
drugi	d r u g i
utracą	u t r a c oc5
wyspiańskiego	v i2 s p i a n~ s k i e g o
podobnej	p o d o b n e j
jakimś	j a k i m sj
bohaterów-	b o h a t e r u v
składnik	s k w a d n i k
simów	sj i m u v
rzęsy	Z eo5 s i2
tchnienie	t h n i e n i e
słowian	s w o v i a n
nieliczni	n i e l j tS n i
miara	m i a r a
oddanego	o d d a n e g o
wiele	v i e l e
pewnego	p e v n e g o
znawcy	z n a v c i2
ponętna	p o n eo5 t n a
powszechna	p o v S e h n a
zafundowaliśmy	z a f u n d o v a l j sj m i2
twarzy	t f a Z i2
b-2	b e o d
pierwszy	p i e r v S i2
leczą	l e tS oc5
her	h e r
zda	z d a
heisenberga	h e i s e n b e r g a
błysk	b w i2 s k
struktura	s t r u k t u r a
owiń	o v i n~
sypkim	s i2 p k i m
bolesną	b o l e s n oc5
wody	v o d i2
komentatorzy	k o m e n t a t o Z i2
zrekompensować	z r e k o m p e n s o v a tsj
nie	n i e
twórcy	t f u r c i2
stanem	s t a n e m
szkole	S k o l e
kartkach	k a r t k a h
wyobraziłam	v i2 o b r a zj i w a m
ciekawsze	tsj e k a v S e
dużo	d u Z o
tarcia	t a r tsj a
świat	sj v i a t
dumanie	d u m a n i e
czegoś	tS e g o sj
zmaganiach	z m a g a n i a h
tak	t a k
seksu	s e k s u
korbę	k o r b e
oczywistym	o tS i2 v i s t i2 m
ma	m a
każdym	k a Z d i2 m
iluminacja	i l u m i n a c j a
kolana	k o l a n a
wymiar	v i2 m i a r
futro	f u t r o
wiedział	v i e dzj a w
chcę	h c e
wyślizgane	v i2 sj l j z g a n e
kamienne	k a m i e n n e
okrążała	o k r oc5 Z a w a
ulokowanej	u l o k o v a n e j
smażonych	s m a Z o n i2 h
zostać	z o s t a tsj
przodu	p S o d u
testujący	t e s t u j oc5 c i2
lat	l a t
pląsająca	p l oc5 s a j oc5 c a
tyle	t i2 l e
wyczerpię	v i2 tS e r p i e
pytam	p i2 t a m
wymaga	v i2 m a g a
odłogiem	o d w o g i e m
spostrzeżenia	s p o s t S e Z e n i a
nieprzezroczystości	n i e p S e z r o tS i2 s t o sj tsj i
milczenia	m i l tS e n i a
peruk	p e r u k
myśleniu	m i2 sj l e n i u
szczery	S tS e r i2
przemienił	p S e m i e n i w
otworem	o t f o r e m
towarzysz	t o v a Z i2 S
kiwają	k i v a j oc5
młodsza	m w o d S a
głos	g w o s
znajdzie	z n a j dzj e
czekającą	tS e k a j oc5 c oc5
szczególnie	S tS e g u l n i e
piany	p i a n i2
drzew	d Z e v
tamten	t a m t e n
romantyczne	r o m a n t i2 tS n e
kategoriach	k a t e g o r j a h
niebiesiech	n i e b i e sj e h
nieczytelna	n i e tS i2 t e l n a
italią	i t a l j oc5
człowieka	tS w o v i e k a
scenę	s c e n e
robi	r o b i
przyjętej	p S i2 j eo5 t e j
zapraszając	z a p r a S a j oc5 c
biorą	b i o r oc5
zaułka	z a u w k a
ciężarów	tsj eo5 Z a r u v
muskaj	m u s k a j
figury	f i g u r i2
misiury	m i sj u r i2
gigantyczną	g i g a n t i2 tS n oc5
miód	m i u d
seks	s e k s
łaskawe	w a s k a v e
doskonałe	d o s k o n a w e
lirę	l j r e
teraz	t e r a z
telewizyjnych	t e l e v i z i2 j n i2 h
uważam	u v a Z a m
kawy	k a v i2
najprościej	n a j p r o sj tsj e j
domagają	d o m a g a j oc5
aleksiej	a l e k sj e j
starym	s t a r i2 m
filtry	f i l t r i2
per	p e r
sprawnie	s p r a v n i e
obejrzysz	o b e j Z i2 S
spłacheć	s p w a h e tsj
pogarda-	p o g a r d a e
johnston	j o h n s t o n
obozu	o b o z u
wacława	v a c w a v a
kwiaty	k f i a t i2
grafomanią	g r a f o m a n i oc5
kitzbuhl	k i t z b u h l
zdarzało	z d a Z a w o
zostawiam	z o s t a v i a m
ludzkie	l u dz k i e
przycisk2_1	p S i2 tsj i s k d v a tS t
poczytnością	p o tS i2 t n o sj tsj oc5
gierka	g i e r k a
wittgenstein	v i t t g e n s t e i n
poznając	p o z n a j oc5 c
odrobiną	o d r o b i n oc5
ziemiom	zj e m i o m
angleberta	a n g l e b e r t a
przypadek	p S i2 p a d e k
jedną	j e d n oc5
chińskiemu	h j n~ s k i e m u
czyny	tS i2 n i2
otaczane	o t a tS a n e
przycisnął	p S i2 tsj i s n oc5 w
piętra	p i eo5 t r a
poszukiwania	p o S u k i v a n i a
dziw	dzj i v
zażywa	z a Z i2 v a
wprowadźmy	v p r o v a dzj m i2
instruujecie	i n s t r u u j e tsj e
zawiódł	z a v i u d w
realnym	r e a l n i2 m
możliwości	m o Z l j v o sj tsj i
blush	b l u s h
pisania	p i s a n i a
przypadkach	p S i2 p a t k a h
bootującej	b o o t u j oc5 c e j
zrobić	z r o b i tsj
boją	b o j oc5
złorzeczenie	z w o Z e tS e n i e
rękę	r eo5 k e
łoskotem	w o s k o t e m
elementarne	e l e m e n t a r n e
wierząc	v i e Z oc5 c
nastroił	n a s t r o i w
złudzeń	z w u dz e n~
zerkać	z e r k a tsj
drivemapper	d r j f e m a p p e r
wszystkiego	v S i2 s t k i e g o
czeluści	tS e l u sj tsj i
ode	o d e
dalekie	d a l e k i e
zmiana	z m i a n a
odważyłem	o d v a Z i2 w e m
krzywdy	k S i2 v d i2
he	h e
zjedzeniu	z j e dz e n i u
dziennikarzy	dzj e n n i k a Z i2
ofert	o f e r t
pierwsza	p i e r v S a
ohydny	o h i2 d n i2
całym	c a w i2 m
samego	s a m e g o
myśl	m i2 sj l
pozycja	p o z i2 c j a
zdobył	z d o b i2 w
miało	m i a w o
grzechu	g Z e h u
wieku	v i e k u
zza	z z a
suchej	s u h e j
stopy	s t o p i2
policzkach	p o l j tS k a h
this	t h j s
lecz	l e tS
wzajemnego	v z a j e m n e g o
pomidorówką	p o m i d o r u v k oc5
utworzyliśmy	u t f o Z i2 l j sj m i2
pytania	p i2 t a n i a
pomyślałem	p o m i2 sj l a w e m
możliwy	m o Z l j v i2
tryb	t r i2 b
błędnym	b w eo5 d n i2 m
zwracamy	z v r a c a m i2
reżyserem	r e Z i2 s e r e m
przygotowałam	p S i2 g o t o v a w a m
pirata	p i r a t a
bełku	b e w k u
metafora	m e t a f o r a
bramą	b r a m oc5
obsługi	o b s w u g i
ról	r u l
niepyszni	n i e p i2 S n i
sufitu	s u f i t u
możesz	m o Z e S
drzewa	d Z e v a
przyspieszać	p S i2 s p i e S a tsj
duchowego	d u h o v e g o
zastawił	z a s t a v i w
brzmi	b Z m i
wypełnić	v i2 p e w n i tsj
zatrzymanych	z a t S i2 m a n i2 h
jakiś	j a k i sj
śledztwo	sj l e dz t f o
poczujesz	p o tS u j e S
złudzenia	z w u dz e n i a
wciągnij	v tsj oc5 g n i j
starożytne	s t a r o Z i2 t n e
chroni	h r o n i
annette	a n n e t t e
fizyki	f i z i2 k i
chwilami	h v i l a m i
polskie	p o l s k i e
podbródek	p o d b r u d e k
psa	p s a
zakrawa	z a k r a v a
jakiegoś	j a k i e g o sj
jazda	j a z d a
hipoteza	h j p o t e z a
puchar	p u h a r
jakaś	j a k a sj
ho	h o
podnoszenie	p o d n o S e n i e
obrazy	o b r a z i2
97	eo5 t e
20	d t
systemem	s i2 s t e m e m
cichutku	tsj i h u t k u
momenty	m o m e n t i2
docierają	d o tsj e r a j oc5
miejsca	m i e j s c a
teorią	t e o r j oc5
skasowanie	s k a s o v a n i e
odważnych	o d v a Z n i2 h
ludzie	l u dzj e
masowymi	m a s o v i2 m i
starcia	s t a r tsj a
religijny	r e l j g i j n i2
zadawać	z a d a v a tsj
modlitwy	m o d l j t f i2
spostrzegłem	s p o s t S e g w e m
mało	m a w o
około	o k o w o
elementy	e l e m e n t i2
niecną	n i e c n oc5
zrobiłaś	z r o b i w a sj
widziałaś	v i dzj a w a sj
tarcic	t a r tsj i c
obudziła	o b u dzj i w a
których	k t u r i2 h
buntowniczy	b u n t o v n i tS i2
miniaturowym	m i n i a t u r o v i2 m
jakieś	j a k i e sj
obcowanie	o b c o v a n i e
przysypanie	p S i2 s i2 p a n i e
dotyczą	d o t i2 tS oc5
zalewała	z a l e v a w a
dotyk	d o t i2 k
reese	r e e s e
przemocy	p S e m o c i2
szybkich	S i2 b k i h
powstając	p o v s t a j oc5 c
wrażliwości	v r a Z l j v o sj tsj i
zdobyć	z d o b i2 tsj
wytępienie	v i2 t eo5 p i e n i e
przesuwamy	p S e s u v a m i2
raną	r a n oc5
złożonej	z w o Z o n e j
pomagać	p o m a g a tsj
długo	d w u g o
fragmentami	f r a g m e n t a m i
przebywają	p S e b i2 v a j oc5
dlaczego	d l a tS e g o
aktywnego	a k t i2 v n e g o
rozwiązania	r o z v i oc5 z a n i a
żelastwa	Z e l a s t f a
sjl	s j l
czucie	tS u tsj e
polegają	p o l e g a j oc5
nimi	n i m i
niespodzianki	n i e s p o dzj a n k i
stole	s t o l e
wniosku	v n i o s k u
polchowa	p o l h o v a
najlepszą	n a j l e p S oc5
utratę	u t r a t e
projekt	p r o j e k t
potworem	p o t f o r e m
otwartego	o t f a r t e g o
współpracowników	v s p u w p r a c o v n i k u v
im	i m
poprosił	p o p r o sj i w
biurowego	b i u r o v e g o
bezbrzeżniej	b e z b Z e Z n i e j
czuje	tS u j e
pracy	p r a c i2
tammona	t a m m o n a
kolejnych	k o l e j n i2 h
cię	tsj i e
podatku	p o d a t k u
wysłany	v i2 s w a n i2
doświadczałeś	d o sj v i a d tS a w e sj
nicości	n i c o sj tsj i
wieczności	v i e tS n o sj tsj i
przestrzeń	p S e s t S e n~
kopalni	k o p a l n i
urządzenie	u Z oc5 dz e n i e
włos	v w o s
steczkowska	s t e tS k o v s k a
często	tS eo5 s t o
przepisywali	p S e p i s i2 v a l j
zaradcze	z a r a d tS e
wrażenie	v r a Z e n i e
notowałem	n o t o v a w e m
źrenice	zj r e n i c e
głośników	g w o sj n i k u v
shop	s h o p
płycie	p w i2 tsj e
zamkniętych-	z a m k n i eo5 t i2 h e
łososi	w o s o sj i
cantilena	c a n t j l e n a
wzruszyło	v z r u S i2 w o
marynarki	m a r i2 n a r k i
księgą	k sj eo5 g oc5
odsłonięcie	o d s w o n i eo5 tsj e
zawarciu	z a v a r tsj u
czasów	tS a s u v
pochodzi	p o h o dzj i
sukcesu	s u k c e s u
lotus	l o t u s
węża	v eo5 Z a
ing	i n g
sens	s e n s
problemem	p r o b l e m e m
razy	r a z i2
przebaczałeś	p S e b a tS a w e sj
wojtek	v o j t e k
fotograficznej	f o t o g r a f i tS n e j
wiekuisty	v i e k u i s t i2
traktuje	t r a k t u j e
kobiet	k o b i e t
chińczycy	h j n~ tS i2 c i2
zapisów	z a p i s u v
ówdzie	u v dzj e
funkcją	f u n k c j oc5
filmów	f i l m u v
potęgi	p o t eo5 g i
świece	sj v i e c e
kota	k o t a
przeżywając	p S e Z i2 v a j oc5 c
model	m o d e l
dialektycznie	d j a l e k t i2 tS n i e
okaże	o k a Z e
akuszera	a k u S e r a
stanowił	s t a n o v i w
ojczyzny	o j tS i2 z n i2
daleka	d a l e k a
brudów	b r u d u v
ubrany	u b r a n i2
stalowe	s t a l o v e
krescencjusza	k r e s c e n c j u S a
ciągu	tsj oc5 g u
kaszubi	k a S u b i
najniższy	n a j n i Z S i2
związkiem	z v i oc5 z k i e m
galaktyk	g a l a k t i2 k
cosmowskazówka	c o s m o v s k a z u v k a
obozowisk	o b o z o v i s k
pqboot	p k b o o t
jakąś	j a k oc5 sj
reakcji	r e a k c j i
gmach	g m a h
eurydyce	e u r i2 d i2 c e
obraca	o b r a c a
reagujesz	r e a g u j e S
kiedyś	k i e d i2 sj
uczestników	u tS e s t n i k u v
opuszczała	o p u S tS a w a
poeta	p o e t a
męki	m eo5 k i
bytów	b i2 t u v
życzliwość	Z i2 tS l j v o sj tsj
dziesiątkuje	dzj e tsj oc5 t k u j e
czytelnik	tS i2 t e l n i k
lutym	l u t i2 m
sił	sj i w
krańce	k r a n~ c e
jeleń	j e l e n~
siera	sj e r a
chciała	h tsj a w a
delikatnie	d e l j k a t n i e
dieta	d j e t a
ostatnią	o s t a t n i oc5
animacje	a n i m a c j e
męskim	m eo5 s k i m
dziwaczny	dzj i v a tS n i2
metodycznemu	m e t o d i2 tS n e m u
trzecia	t S e tsj a
musiało	m u tsj a w o
zainteresowania	z a i n t e r e s o v a n i a
byłem	b i2 w e m
nieprzegotowanej	n i e p S e g o t o v a n e j
lata-	l a t a e
zadowolenia	z a d o v o l e n i a
kopią	k o p i oc5
pomoże	p o m o Z e
przyrostowej-	p S i2 r o s t o v e j e
nabierzesz	n a b i e Z e S
punkt	p u n k t
tytułem	t i2 t u w e m
dziwami	dzj i v a m i
znajomi	z n a j o m i
przykładam	p S i2 k w a d a m
nigdy	n i g d i2
rozmaite	r o z m a i t e
wstrzymany	v s t S i2 m a n i2
stać	s t a tsj
kolano	k o l a n o
banalną	b a n a l n oc5
odbicie	o d b i tsj e
telewizorem	t e l e v i z o r e m
pytali	p i2 t a l j
jaki	j a k i
olbrzymi	o l b Z i2 m i
ostatnie	o s t a t n i e
końcu	k o n~ c u
underwear	u n d e r v e a r
boski	b o s k i
spokój	s p o k u j
zyskuje	z i2 s k u j e
profesjonalnie	p r o f e s j o n a l n i e
jean	j e a n
podpisywać	p o d p i s i2 v a tsj
idealnym	i d e a l n i2 m
kumulacji	k u m u l a c j i
fatalną	f a t a l n oc5
komunię	k o m u n i e
gęby	g eo5 b i2
zwolennikom	z v o l e n n i k o m
historię	h j s t o r j e
rozwiązać	r o z v i oc5 z a tsj
wojnę	v o j n e
opierał	o p i e r a w
uniknąć	u n i k n oc5 tsj
straszliwie	s t r a S l j v i e
feynmana	f e i2 n m a n a
zamczyska	z a m tS i2 s k a
pewnej	p e v n e j
korzystam	k o Z i2 s t a m
czyśćca	tS i2 sj tsj c a
not	n o t
straciła	s t r a tsj i w a
absolutnym	a b s o l u t n i2 m
świąt	sj v i oc5 t
czuję	tS u j e
regionalnych	r e g i o n a l n i2 h
gaszę	g a S e
rozproszonych	r o z p r o S o n i2 h
świńskim	sj v i n~ s k i m
sprytnym	s p r i2 t n i2 m
wiary	v i a r i2
odbędzie	o d b eo5 dzj e
byliśmy	b i2 l j sj m i2
zewnętrzny	z e v n eo5 t S n i2
ludzkości	l u dz k o sj tsj i
prezentację	p r e z e n t a c j e
murami	m u r a m i
wydobycia	v i2 d o b i2 tsj a
imię	i m i e
odpoczynku	o d p o tS i2 n k u
tajny	t a j n i2
krwistych	k r v i s t i2 h
ponosi	p o n o sj i
paul	p a u l
sądzić	s oc5 dzj i tsj
profesjonalnych	p r o f e s j o n a l n i2 h
zachowań	z a h o v a n~
wartości	v a r t o sj tsj i
kostiumach	k o s t j u m a h
zagadnienie	z a g a d n i e n i e
udają	u d a j oc5
futurystyczna	f u t u r i2 s t i2 tS n a
mówienia	m u v i e n i a
wstydu	v s t i2 d u
annie	a n n i e
rozbiję	r o z b i j e
patrzcie	p a t S tsj e
wytarte	v i2 t a r t e
zielonego	zj e l o n e g o
niespokojny	n i e s p o k o j n i2
pozostawić	p o z o s t a v i tsj
progi	p r o g i
porażony	p o r a Z o n i2
byłoby	b i2 w o b i2
urodziło	u r o dzj i w o
obejmuje	o b e j m u j e
zachowywać	z a h o v i2 v a tsj
i	i
stuleci	s t u l e tsj i
łaszyńskich	w a S i2 n~ s k i h
przekonana	p S e k o n a n a
krewniak	k r e v n i a k
piękniejszy	p i eo5 k n i e j S i2
muszę	m u S e
wybrzeżach	v i2 b Z e Z a h
odpadłaś	o d p a d w a sj
dłońmi	d w o n~ m i
barwnika	b a r v n i k a
długa	d w u g a
przeszłości	p S e S w o sj tsj i
zmianie	z m i a n i e
powiada	p o v i a d a
zabijał	z a b i j a w
wrażliwość	v r a Z l j v o sj tsj
brałam	b r a w a m
inne	i n n e
kolacje	k o l a c j e
razem	r a z e m
znaczącym	z n a tS oc5 c i2 m
szanowany	S a n o v a n i2
prozaiczny	p r o z a i tS n i2
obdarzonych	o b d a Z o n i2 h
przemianę	p S e m i a n e
życzenie	Z i2 tS e n i e
wykazał	v i2 k a z a w
procesu	p r o c e s u
wytropiła	v i2 t r o p i w a
oglądałaś	o g l oc5 d a w a sj
pracownicy	p r a c o v n i c i2
tworzeniem	t f o Z e n i e m
przekazach	p S e k a z a h
zdarza	z d a Z a
nas	n a s
wydaje	v i2 d a j e
śmierć	sj m i e r tsj
należą	n a l e Z oc5
krzątał	k S oc5 t a w
nauki	n a u k i
przystąpimy	p S i2 s t oc5 p i m i2
czele	tS e l e
poszukiwacz	p o S u k i v a tS
oni	o n i
ekspresji	e k s p r e s j i
poczuć	p o tS u tsj
kimś-	k i m sj e
zabrzmi	z a b Z m i
utworzy	u t f o Z i2
przedostatni	p S e d o s t a t n i
państwowego	p a n~ s t f o v e g o
3	S i2
swobodna	s v o b o d n a
polski	p o l s k i
przekroczenie	p S e k r o tS e n i e
komtur	k o m t u r
aparat	a p a r a t
określonego	o k r e sj l o n e g o
wolno	v o l n o
ziemia	zj e m i a
wietnamie	v i e t n a m i e
równi	r u v n i
punktem	p u n k t e m
umyciu	u m i2 tsj u
ramionami	r a m i o n a m i
górnej	g u r n e j
gdera:-	g d e r a e
szanowani	S a n o v a n i
specjalnego	s p e c j a l n e g o
gomułki	g o m u w k i
wysiadają	v i2 tsj a d a j oc5
70	sj t
ckm	c k m
bawary	b a v a r i2
przeżywałeś	p S e Z i2 v a w e sj
spaść	s p a sj tsj
teksty	t e k s t i2
chaosie	h a o sj e
mór	m u r
ciało	tsj a w o
potwierdzi	p o t f i e r dzj i
królewic	k r u l e v i c
możliwościach	m o Z l j v o sj tsj a h
potrafi	p o t r a f i
działy	dzj a w i2
żertwę	Z e r t f e
owszem	o v S e m
była	b i2 w a
młodzieńca	m w o dzj e n~ c a
itd	i t d
podziemnego	p o dzj e m n e g o
stara	s t a r a
merkury	m e r k u r i2
szefową	S e f o v oc5
zaś	z a sj
młodego	m w o d e g o
drzwiach	d Z v i a h
nagięty	n a g i eo5 t i2
przyjaciołom	p S i2 j a tsj o w o m
podłoża	p o d w o Z a
kuchennej	k u h e n n e j
powstrzymać	p o v s t S i2 m a tsj
przywróceniu	p S i2 v r u c e n i u
segmentach	s e g m e n t a h
otworzyło	o t f o Z i2 w o
budzi	b u dzj i
kołatał	k o w a t a w
szanse	S a n s e
sześciuset	S e sj tsj u s e t
miliardów	m i l j a r d u v
mądrości	m oc5 d r o sj tsj i
każdą	k a Z d oc5
modułu	m o d u w u
niewzruszalną	n i e v z r u S a l n oc5
niosą	n i o s oc5
inny	i n n i2
substancji	s u b s t a n c j i
pięciu	p i eo5 tsj u
przemieniające	p S e m i e n i a j oc5 c e
niektórych	n i e k t u r i2 h
janusza	j a n u S a
loki	l o k i
sami	s a m i
zmielonych	z m i e l o n i2 h
musimy	m u sj i m i2
niedoczytanej	n i e d o tS i2 t a n e j
gdy	g d i2
najbardziej	n a j b a r dzj e j
powrócił	p o v r u tsj i w
krzyż	k S i2 S
felietony	f e l j e t o n i2
żeby	Z e b i2
opromienione	o p r o m i e n i o n e
łabą	w a b oc5
chodzi	h o dzj i
dusza	d u S a
fair	f a i r
wiedząc	v i e dz oc5 c
stworzeniu	s t f o Z e n i u
wstąpić	v s t oc5 p i tsj
uniknąłby	u n i k n oc5 w b i2
sądzą	s oc5 dz oc5
upodobał	u p o d o b a w
nieba	n i e b a
wywołaną	v i2 v o w a n oc5
rozpalania	r o z p a l a n i a
jezu	j e z u
zdobywał	z d o b i2 v a w
odbywa	o d b i2 v a
skończy	s k o n~ tS i2
samochodowe	s a m o h o d o v e
integralny	i n t e g r a l n i2
faulkner	f a u l k n e r
zapisał	z a p i s a w
niejeden	n i e j e d e n
oglądali	o g l oc5 d a l j
paru	p a r u
ludziom	l u dzj o m
prawo	p r a v o
fantastycznie	f a n t a s t i2 tS n i e
wydarzenia	v i2 d a Z e n i a
skandalu	s k a n d a l u
true	t r u e
obowiązkami	o b o v i oc5 z k a m i
odrzuceniu	o d Z u c e n i u
powieściowy	p o v i e sj tsj o v i2
nieprzyjaciel	n i e p S i2 j a tsj e l
mieszkanka	m i e S k a n k a
swą	s v oc5
zamierzony	z a m i e Z o n i2
cnotę	c n o t e
możemy	m o Z e m i2
nieładne	n i e w a d n e
leśne	l e sj n e
syn	s i2 n
boskich	b o s k i h
teutońskiego	t e u t o n~ s k i e g o
kilograma	k i l o g r a m a
niebezpiecznych	n i e b e z p i e tS n i2 h
pory	p o r i2
poręki	p o r eo5 k i
władzę	v w a dz e
kobieta	k o b i e t a
przychodzimy	p S i2 h o dzj i m i2
lubrykantem	l u b r i2 k a n t e m
bieliznę	b i e l j z n e
zwykli	z v i2 k l j
powrotem	p o v r o t e m
popełnić	p o p e w n i tsj
nadzieja	n a dzj e j a
celebrując	c e l e b r u j oc5 c
borami	b o r a m i
podaje	p o d a j e
sobie	s o b i e
informowania	i n f o r m o v a n i a
odwiecznych	o d v i e tS n i2 h
owej	o v e j
szanowaną	S a n o v a n oc5
gęstość	g eo5 s t o sj tsj
część	tS eo5 sj tsj
poszukiwaniu	p o S u k i v a n i u
poematu	p o e m a t u
chwycił	h v i2 tsj i w
ciotka	tsj o t k a
steków	s t e k u v
środowisku	sj r o d o v i s k u
krzywoustego	k S i2 v o u s t e g o
strzały	s t S a w i2
testamencie	t e s t a m e n tsj e
uzależnionych	u z a l e Z n i o n i2 h
obraża	o b r a Z a
wyjścia	v i2 j sj tsj a
potem	p o t e m
procent	p r o c e n t
dobra	d o b r a
sama	s a m a
studentki	s t u d e n t k i
doskonała	d o s k o n a w a
bardzo	b a r dz o
musisz	m u sj i S
moc	m o c
opowiadania	o p o v i a d a n i a
suwak	s u v a k
ziemi	zj e m i
it	i t
bryki	b r i2 k i
syntezy	s i2 n t e z i2
godność	g o d n o sj tsj
minimum	m i n i m u m
podniety	p o d n i e t i2
analityk	a n a l j t i2 k
mascara	m a s c a r a
potęgą	p o t eo5 g oc5
firmy	f i r m i2
zasobów	z a s o b u v
stworzoną	s t f o Z o n oc5
przekracza	p S e k r a tS a
wczołgiwanie	v tS o w g i v a n i e
przekonałaś	p S e k o n a w a sj
centrum	c e n t r u m
krył	k r i2 w
umysł	u m i2 s w
uważasz	u v a Z a S
chorobie	h o r o b i e
urzędnik	u Z eo5 d n i k
katedrę	k a t e d r e
wszelkie	v S e l k i e
wymasuj	v i2 m a s u j
strategię	s t r a t e g i e
osoby	o s o b i2
nazywany	n a z i2 v a n i2
nowemu	n o v e m u
ja	j a
popatrzeć	p o p a t S e tsj
praca	p r a c a
zapisywałem	z a p i s i2 v a w e m
dochodowego	d o h o d o v e g o
lekcji	l e k c j i
miałoby	m i a w o b i2
wyprodukował	v i2 p r o d u k o v a w
pseudonimem	p s e u d o n i m e m
strasznie	s t r a S n i e
romanse	r o m a n s e
głębia	g w eo5 b i a
eseju	e s e j u
lekarzy	l e k a Z i2
wnet	v n e t
weselą	v e s e l oc5
platonie	p l a t o n i e
drogą	d r o g oc5
wyobrazić	v i2 o b r a zj i tsj
wrzask	v Z a s k
był	b i2 w
urządzenia	u Z oc5 dz e n i a
chojnickiej	h o j n i c k i e j
30	o
william	v i l l j a m
skrwawiony	s k r v a v i o n i2
pustki	p u s t k i
dwunastu	d v u n a s t u
pewnością	p e v n o sj tsj oc5
fiołkami	f i o w k a m i
sceptyk	s c e p t i2 k
pokazującą	p o k a z u j oc5 c oc5
ceremonii	c e r e m o n i i
napastnicy	n a p a s t n i c i2
bujasz	b u j a S
przyjmują	p S i2 j m u j oc5
prawnych	p r a v n i2 h
frontpage	f r o n t p a g e
wypraszając	v i2 p r a S a j oc5 c
naszemu	n a S e m u
swej	s v e j
antyku	a n t i2 k u
ambitni	a m b i t n i
bruyere	b r u i2 e r e
lovers	l o f e r s
żwawo	Z v a v o
zła	z w a
grudka	g r u t k a
kaca	k a c a
tworzywa	t f o Z i2 v a
pieszczotą	p i e S tS o t oc5
wyścigu	v i2 sj tsj i g u
zostało	z o s t a w o
bezkarnie	b e z k a r n i e
religijną	r e l j g i j n oc5
supermocny	s u p e r m o c n i2
opatom	o p a t o m
bólu	b u l u
rozłąki	r o z w oc5 k i
lubiłem	l u b i w e m
aplikacji	a p l j k a c j i
masaże	m a s a Z e
przestrogi	p S e s t r o g i
rycerzom-	r i2 c e Z o m e
dotykają	d o t i2 k a j oc5
czynów	tS i2 n u v
aromatycznych	a r o m a t i2 tS n i2 h
piraci	p i r a tsj i
sieci	sj e tsj i
obodryci	o b o d r i2 tsj i
wetknąć	v e t k n oc5 tsj
u	u
stanie	s t a n i e
ich	i h
punktualności	p u n k t u a l n o sj tsj i
odpadł	o d p a d w
układzie	u k w a dzj e
dziwne	dzj i v n e
gburstwa	g b u r s t f a
jądrze	j oc5 d Z e
zrozumieniu	z r o z u m i e n i u
przestrzeni	p S e s t S e n i
wstąpi	v s t oc5 p i
swoje	s v o j e
orfeusz	o r f e u S
przygotowanie	p S i2 g o t o v a n i e
działo	dzj a w o
francuskiego	f r a n c u s k i e g o
pana	p a n a
stosowanie	s t o s o v a n i e
znajduje	z n a j d u j e
shu-king	s h u k i n g
kamieni	k a m i e n i
poszła	p o S w a
menu	m e n u
przynosi	p S i2 n o sj i
posłał	p o s w a w
wielu	v i e l u
warto	v a r t o
autorytet	a u t o r i2 t e t
niemal	n i e m a l
największy	n a j v i eo5 k S i2
30-letnia	o l e t n i a
charakterystyczna	h a r a k t e r i2 s t i2 tS n a
opłakania	o p w a k a n i a
słyszałem	s w i2 S a w e m
odrealniony	o d r e a l n i o n i2
najlepszej	n a j l e p S e j
zostaniemy	z o s t a n i e m i2
wieki	v i e k i
smaczna	s m a tS n a
lekceważyć	l e k c e v a Z i2 tsj
odrazy	o d r a z i2
takie	t a k i e
latać	l a t a tsj
coś	c o sj
mistrza	m i s t S a
wieków	v i e k u v
ukazującego	u k a z u j oc5 c e g o
ciężar	tsj eo5 Z a r
ojca	o j c a
lusterka	l u s t e r k a
literowe	l j t e r o v e
kupić	k u p i tsj
zapytam	z a p i2 t a m
mój	m u j
będziesz	b eo5 dzj e S
opat	o p a t
pięknego	p i eo5 k n e g o
obserwatora	o b s e r v a t o r a
pomińmy	p o m i n~ m i2
możliwe	m o Z l j v e
przyznać	p S i2 z n a tsj
następujących	n a s t eo5 p u j oc5 c i2 h
mama	m a m a
kształtów	k S t a w t u v
przyjmuję	p S i2 j m u j e
pejzaż	p e j z a S
rzuceniu	Z u c e n i u
mocami	m o c a m i
on	o n
wiatrem	v i a t r e m
znanych	z n a n i2 h
unosisz	u n o sj i S
cat	c a t
umieli	u m i e l j
puste	p u s t e
obciążeniem	o b tsj oc5 Z e n i e m
rodzice	r o dzj i c e
wskazać	v s k a z a tsj
uciekł	u tsj e k w
czyn	tS i2 n
temat	t e m a t
materialność	m a t e r j a l n o sj tsj
obiektów	o b i e k t u v
księstwa	k sj eo5 s t f a
adrenaliny	a d r e n a l j n i2
and	a n d
sade	s a d e
otrucia	o t r u tsj a
taki	t a k i
środka	sj r o t k a
medycyna	m e d i2 c i2 n a
konflikt	k o n f l j k t
uczył	u tS i2 w
przeszywał	p S e S i2 v a w
pozwala	p o z v a l a
spoczywające	s p o tS i2 v a j oc5 c e
ruszył	r u S i2 w
z	z
produktów	p r o d u k t u v
zleciało	z l e tsj a w o
najszybciej	n a j S i2 b tsj e j
aktorska	a k t o r s k a
ot	o t
antycznej	a n t i2 tS n e j
fabryką	f a b r i2 k oc5
skarpety	s k a r p e t i2
wałeczki	v a w e tS k i
naruszających	n a r u S a j oc5 c i2 h
radzić	r a dzj i tsj
znak	z n a k
mieli	m i e l j
natury	n a t u r i2
zostaną	z o s t a n oc5
warszawscy	v a r S a v s c i2
całą	c a w oc5
enough	e n o u g h
mózgu	m u z g u
wypełnia	v i2 p e w n i a
dopingowała	d o p i n g o v a w a
marzyła	m a Z i2 w a
hermes	h e r m e s
chromosom	h r o m o s o m
choć	h o tsj
zakonem	z a k o n e m
zamknął	z a m k n oc5 w
dorzucić	d o Z u tsj i tsj
biegali	b i e g a l j
ciekawe	tsj e k a v e
urodził	u r o dzj i w
odstępujesz	o d s t eo5 p u j e S
postaciach	p o s t a tsj a h
śląska	sj l oc5 s k a
poganami	p o g a n a m i
powodzenia	p o v o dz e n i a
członek	tS w o n e k
nauczyciel	n a u tS i2 tsj e l
zewnętrznej	z e v n eo5 t S n e j
mu	m u
naświetlonej	n a sj v i e t l o n e j
kujawy	k u j a v i2
warstwą	v a r s t f oc5
pluta	p l u t a
ów	u v
nastolatki	n a s t o l a t k i
powątpiewać	p o v oc5 t p i e v a tsj
znacznie	z n a tS n i e
drugiej	d r u g i e j
układ	u k w a d
pociągnęła	p o tsj oc5 g n eo5 w a
kompletnej	k o m p l e t n e j
względu	v z g l eo5 d u
poszukać	p o S u k a tsj
pokój	p o k u j
uchodzą	u h o dz oc5
eklektyczną	e k l e k t i2 tS n oc5
czytelników	tS i2 t e l n i k u v
krótkie	k r u t k i e
czyli	tS i2 l j
pozostaje	p o z o s t a j e
politykiem	p o l j t i2 k i e m
zachwyt	z a h v i2 t
gronostajami	g r o n o s t a j a m i
zamieszkałych	z a m i e S k a w i2 h
wierzysz	v i e Z i2 S
wyznawców-	v i2 z n a v c u v
odpowiedzialnego	o d p o v i e dzj a l n e g o
tłumaczy	t w u m a tS i2
jezusa	j e z u s a
ściany	sj tsj a n i2
niekłamaną	n i e k w a m a n oc5
dotrzeć	d o t S e tsj
ćwiczy	tsj v i tS i2
napełnia	n a p e w n i a
upierzone	u p i e Z o n e
szmat	S m a t
stąd	s t oc5 d
izraela	i z r a e l a
łodzie	w o dzj e
głosów	g w o s u v
trąbce	t r oc5 b c e
skoro	s k o r o
zdjął	z d j oc5 w
mimo	m i m o
to	t o
gra	g r a
widowiska	v i d o v i s k a
biodra	b i o d r a
poznania	p o z n a n i a
wiarygodna	v i a r i2 g o d n a
pięć	p i eo5 tsj
akwinu-	a k f i n u
cesarski-	c e s a r s k i e
poprzez	p o p S e z
daleki	d a l e k i
testującej	t e s t u j oc5 c e j
zmysłach	z m i2 s w a h
awantury	a v a n t u r i2
czoło	tS o w o
fryzjerem	f r i2 z j e r e m
tulum	t u l u m
tej	t e j
krainy	k r a i n i2
camus	c a m u s
podczas	p o d tS a s
sprzyjający	s p S i2 j a j oc5 c i2
diana	d j a n a
uciekał	u tsj e k a w
boże	b o Z e
budowa	b u d o v a
wysokie	v i2 s o k i e
kąśliwe	k oc5 sj l j v e
trzpieniach	t S p i e n i a h
piłki	p i w k i
marce	m a r c e
studiujesz	s t u d j u j e S
dokumentów	d o k u m e n t u v
ogarnia	o g a r n i a
gotów	g o t u v
niebiosa	n i e b i o s a
różu	r u Z u
pollard	p o l l a r d
oparzenia	o p a Z e n i a
mordercy	m o r d e r c i2
zwane	z v a n e
zwariowała	z v a r j o v a w a
dotychczas	d o t i2 h tS a s
amfetaminę	a m f e t a m i n e
bije	b i j e
przemieszcza	p S e m i e S tS a
1987	v i eo5 t sj oc5 e
uzależnienia	u z a l e Z n i e n i a
zatoka	z a t o k a
aktorskiego	a k t o r s k i e g o
szlachetnych	S l a h e t n i2 h
którzy	k t u Z i2
mężowi	m eo5 Z o v i
umieścimy	u m i e sj tsj i m i2
ziemią	zj e m i oc5
sytuacją	s i2 t u a c j oc5
doniesienia	d o n i e sj e n i a
mordercami	m o r d e r c a m i
temu	t e m u
cierpienia	tsj e r p i e n i a
maską	m a s k oc5
siebie	sj e b i e
opowieść	o p o v i e sj tsj
nieudana	n i e u d a n a
bez	b e z
niczego	n i tS e g o
krwawego	k r v a v e g o
pracą	p r a c oc5
ręki	r eo5 k i
dwa-	d v a e
przyjacielem	p S i2 j a tsj e l e m
poły	p o w i2
czajki	tS a j k i
nadmiernym	n a d m i e r n i2 m
ludu	l u d u
lasek	l a s e k
alkoholu	a l k o h o l u
dziwem	dzj i v e m
talenty	t a l e n t i2
gorzej	g o Z e j
wasza	v a S a
aleksy	a l e k s i2
zasięgiem	z a sj eo5 g i e m
rzymskiej	Z i2 m s k i e j
zgiełku	z g i e w k u
znaczy	z n a tS i2
chodzenia	h o dz e n i a
loży	l o Z i2
stróża	s t r u Z a
przyjmowali	p S i2 j m o v a l j
zapraszam	z a p r a S a m
prostak	p r o s t a k
arcydzieło	a r c i2 dzj e w o
trwania	t r v a n i a
gumy	g u m i2
dół-	d u w e
komputery	k o m p u t e r i2
skazani-	s k a z a n i e
rzymska	Z i2 m s k a
pomaga	p o m a g a
tajemnicy	t a j e m n i c i2
nadwagę	n a d v a g e
szalem	S a l e m
ambicji	a m b i c j i
poruszasz	p o r u S a S
mogą	m o g oc5
klasyków	k l a s i2 k u v
przesławny	p S e s w a v n i2
rany	r a n i2
dział	dzj a w
odrestaurowane	o d r e s t a u r o v a n e
niektóre	n i e k t u r e
drogi	d r o g i
wykorzystujesz	v i2 k o Z i2 s t u j e S
zaczyn	z a tS i2 n
sprzedaż	s p S e d a S
postawie	p o s t a v i e
internetowym	i n t e r n e t o v i2 m
chwilce	h v i l c e
bardziej	b a r dzj e j
przytyłam	p S i2 t i2 w a m
216	d o S e s
lub	l u b
łodzią	w o dzj oc5
spadkobiercy	s p a t k o b i e r c i2
zabawne	z a b a v n e
zakonnika	z a k o n n i k a
anna	a n n a
interfejsu	i n t e r f e j s u
muszkę	m u S k e
specjalistów	s p e c j a l j s t u v
pokornym	p o k o r n i2 m
absalom	a b s a l o m
orfeusza	o r f e u S a
wybór	v i2 b u r
lotnictwa	l o t n i c t f a
zdemoralizowanego	z d e m o r a l j z o v a n e g o
wiarygodnej	v i a r i2 g o d n e j
zalegał	z a l e g a w
zestawów	z e s t a v u v
głośnika	g w o sj n i k a
przyjściem	p S i2 j sj tsj e m
wylewali	v i2 l e v a l j
widziała	v i dzj a w a
nowe	n o v e
apostolstwa	a p o s t o l s t f a
osjan	o s j a n
szesnastolatek	S e s n a s t o l a t e k
postrzegany	p o s t S e g a n i2
wiersze	v i e r S e
wyniku	v i2 n i k u
chwili	h v i l j
według	v e d w u g
potężnego	p o t eo5 Z n e g o
alkohol	a l k o h o l
umarł	u m a r w
chrystus	h r i2 s t u s
baśniach	b a sj n i a h
zdecydowanych	z d e c i2 d o v a n i2 h
tymi	t i2 m i
wyładniała	v i2 w a d n i a w a
nowy	n o v i2
lęków	l eo5 k u v
widać	v i d a tsj
spopielałych	s p o p i e l a w i2 h
napisał	n a p i s a w
przykłady	p S i2 k w a d i2
18	s t e
teatrze	t e a t S e
wyżej	v i2 Z e j
jadowitego	j a d o v i t e g o
aktorki	a k t o r k i
formosus	f o r m o s u s
napotkanego	n a p o t k a n e g o
nocy	n o c i2
botanik	b o t a n i k
zadbać	z a d b a tsj
dobroczynne	d o b r o tS i2 n n e
okresie	o k r e sj e
wybacza	v i2 b a tS a
dekoracja	d e k o r a c j a
równolegle	r u v n o l e g l e
ucho	u h o
procesy	p r o c e s i2
1930)-	v i eo5 t o e
rybka	r i2 b k a
styl	s t i2 l
zajęcia	z a j eo5 tsj a
oparty	o p a r t i2
odwagę	o d v a g e
dołącz	d o w oc5 tS
płeć	p w e tsj
wieprz	v i e p S
wy	v i2
nieustannie	n i e u s t a n n i e
sekwencję	s e k f e n c j e
postęp	p o s t eo5 p
wykryć	v i2 k r i2 tsj
zbudowałem	z b u d o v a w e m
warianowa	v a r j a n o v a
pochyla	p o h i2 l a
podrywał	p o d r i2 v a w
twórcza	t f u r tS a
uczeńców	u tS e n~ c u v
ducha	d u h a
przytoczyć	p S i2 t o tS i2 tsj
zagarnąć	z a g a r n oc5 tsj
najtrudniejszych	n a j t r u d n i e j S i2 h
modlitwie	m o d l j t f i e
larry	l a r r i2
marcel	m a r c e l
przeciwnika	p S e tsj i v n i k a
wojennik	v o j e n n i k
miejscu	m i e j s c u
rację	r a c j e
nieładzie	n i e w a dzj e
henryka	h e n r i2 k a
przerywamy	p S e r i2 v a m i2
niewielka	n i e v i e l k a
chcieli	h tsj e l j
tercjami	t e r c j a m i
głębi	g w eo5 b i
chodziłem	h o dzj i w e m
zaprząta	z a p S oc5 t a
pszczoły	p S tS o w i2
magiczna	m a g i tS n a
gazety	g a z e t i2
pokaż	p o k a S
narodzin	n a r o dzj i n
jonatana	j o n a t a n a
końców	k o n~ c u v
burdel	b u r d e l
pazura	p a z u r a
program	p r o g r a m
lepiej	l e p i e j
ramieniu	r a m i e n i u
rock	r o c k
powietrze	p o v i e t S e
poniekąd	p o n i e k oc5 d
widywać	v i d i2 v a tsj
podobałaś	p o d o b a w a sj
dwóch	d v u h
dziękuje	dzj eo5 k u j e
wyprzedaże	v i2 p S e d a Z e
polach	p o l a h
raduje	r a d u j e
obitej	o b i t e j
prozaiczne	p r o z a i tS n e
arcydziełem	a r c i2 dzj e w e m
sypkie	s i2 p k i e
orderu	o r d e r u
al-afghani	a l a f g h a n i
nieruchomego	n i e r u h o m e g o
dziękowali	dzj eo5 k o v a l j
wytrwałych	v i2 t r v a w i2 h
miejscem	m i e j s c e m
szans	S a n s
wszystko	v S i2 s t k o
okazało	o k a z a w o
przekraczają	p S e k r a tS a j oc5
wyrażające	v i2 r a Z a j oc5 c e
instalowany	i n s t a l o v a n i2
księciem	k sj eo5 tsj e m
studenci	s t u d e n tsj i
pewność	p e v n o sj tsj
fizycznego	f i z i2 tS n e g o
mąkę	m oc5 k e
odnośnik	o d n o sj n i k
odróżnieniu	o d r u Z n i e n i u
room	r o o m
półwysep	p u w v i2 s e p
rzekę	Z e k e
al-jihad	a l j j h a d
głowie	g w o v i e
wszechistnienie	v S e h i s t n i e n i e
leżał	l e Z a w
wielokroć	v i e l o k r o tsj
9	eo5 tsj
rozpocząłeś	r o z p o tS oc5 w e sj
zerwał	z e r v a w
berenta	b e r e n t a
konsekwencje	k o n s e k f e n c j e
pojawiać	p o j a v i a tsj
kilkunastu	k i l k u n a s t u
płakałam	p w a k a w a m
życzliwemu	Z i2 tS l j v e m u
kilogramów	k i l o g r a m u v
wojciech	v o j tsj e h
waszą	v a S oc5
szpulowych	S p u l o v i2 h
tysiąc	t i2 tsj oc5 c
kinie	k i n i e
postaramy	p o s t a r a m i2
przedmiotów-	p S e d m i o t u v
zamieszczają	z a m i e S tS a j oc5
głośno	g w o sj n o
zainstalować	z a i n s t a l o v a tsj
pełnej	p e w n e j
oburącz	o b u r oc5 tS
makatek	m a k a t e k
całkowitego	c a w k o v i t e g o
poskramiającego	p o s k r a m i a j oc5 c e g o
bóg-	b u g e
ślubną	sj l u b n oc5
całemu	c a w e m u
światłu	sj v i a t w u
odwołując	o d v o w u j oc5 c
b-24	b e d tS t
pokłóciła	p o k w u tsj i w a
mały	m a w i2
striptiz	s t r j p t j z
byłby	b i2 w b i2
rzesze	Z e S e
umiem	u m i e m
najukochańsze	n a j u k o h a n~ S e
byli	b i2 l j
maksymy	m a k s i2 m i2
wrócić	v r u tsj i tsj
automatycznie	a u t o m a t i2 tS n i e
licząc	l j tS oc5 c
całkowitej	c a w k o v i t e j
zakładamy	z a k w a d a m i2
oniryczna	o n i r i2 tS n a
dźwiękowej	dzj v i eo5 k o v e j
zarys	z a r i2 s
dudniących	d u d n i oc5 c i2 h
ceglanymi	c e g l a n i2 m i
produkcję	p r o d u k c j e
byłeś	b i2 w e sj
jak	j a k
ją	j oc5
leży	l e Z i2
przyszedł	p S i2 S e d w
powinni	p o v i n n i
aktorką	a k t o r k oc5
dołączania	d o w oc5 tS a n i a
życzenia	Z i2 tS e n i a
porozmawiaj	p o r o z m a v i a j
czego	tS e g o
przyjaźniach	p S i2 j a zj n i a h
najwcześniejszy	n a j v tS e sj n i e j S i2
ukryte	u k r i2 t e
czułych	tS u w i2 h
dwa	d v a
bestsellerów	b e s t s e l l e r u v
osadzone	o s a dz o n e
piętnaście	p i eo5 t n a sj tsj e
krain	k r a i n
paolo	p a o l o
ulubiona	u l u b i o n a
nadzieję	n a dzj e j e
cenzorskich	c e n z o r s k i h
każdy	k a Z d i2
technologia	t e h n o l o g i a
dom	d o m
grudami	g r u d a m i
ujście	u j sj tsj e
elite	e l j t e
poza	p o z a
reguł	r e g u w
zwyczajnie	z v i2 tS a j n i e
ostro	o s t r o
ochoty	o h o t i2
warg	v a r g
oprzeć	o p S e tsj
eurydykę	e u r i2 d i2 k e
prawdą	p r a v d oc5
absolutny	a b s o l u t n i2
zasadza	z a s a dz a
wszystkich	v S i2 s t k i h
przecież	p S e tsj e S
katedr	k a t e d r
już	j u S
autorów	a u t o r u v
kręgach	k r eo5 g a h
sygnał	s i2 g n a w
zamieszczamy	z a m i e S tS a m i2
pozostawili	p o z o s t a v i l j
wypuścić	v i2 p u sj tsj i tsj
drugoligowy	d r u g o l j g o v i2
rozbudowanym	r o z b u d o v a n i2 m
palcami	p a l c a m i
bezprawia	b e z p r a v i a
sarabandę	s a r a b a n d e
tobą	t o b oc5
buckle'a	b u c k l e a
rękami	r eo5 k a m i
epp	e p p
iwo	i v o
dziś	dzj i sj
mnożenia	m n o Z e n i a
mniejsze	m n i e j S e
strażników	s t r a Z n i k u v
iluzyjnym	i l u z i2 j n i2 m
autentyczne	a u t e n t i2 tS n e
adorowali	a d o r o v a l j
długowłosych	d w u g o v w o s i2 h
momencie	m o m e n tsj e
ci	tsj i
autor	a u t o r
zapasowa	z a p a s o v a
znaków	z n a k u v
tajemnica	t a j e m n i c a
domową	d o m o v oc5
malezja	m a l e z j a
tę	t e
młotem	m w o t e m
organizmu	o r g a n i z m u
obszarów	o b S a r u v
kaset	k a s e t
pustą	p u s t oc5
błogosławiona	b w o g o s w a v i o n a
monako	m o n a k o
mała	m a w a
zł	z w
chrobrego	h r o b r e g o
maja	m a j a
wieczoru	v i e tS o r u
drewnianą	d r e v n i a n oc5
pomysł	p o m i2 s w
1918)-	v i eo5 t o o sj e
pragmatycznym	p r a g m a t i2 tS n i2 m
pisać	p i s a tsj
filmy	f i l m i2
pakietu	p a k i e t u
dobrem	d o b r e m
nadal	n a d a l
danie	d a n i e
dorównuje	d o r u v n u j e
lat-	l a t
korzystasz	k o Z i2 s t a S
obsesja	o b s e s j a
podtrzymuje	p o d t S i2 m u j e
powielać	p o v i e l a tsj
nbc	n b c
interwencji	i n t e r v e n c j i
historie	h j s t o r j e
warner	v a r n e r
nabierają	n a b i e r a j oc5
dolinę	d o l j n e
zbliżało	z b l j Z a w o
umyka	u m i2 k a
wpłynie	v p w i2 n i e
uśmiechnięty	u sj m i e h n i eo5 t i2
dotrzymaj	d o t S i2 m a j
terminów	t e r m i n u v
opiekunie	o p i e k u n i e
bądź	b oc5 dzj
chlubnie	h l u b n i e
czyni	tS i2 n i
wielką	v i e l k oc5
tego	t e g o
kanapie	k a n a p i e
maurice	m a u r j c e
wzdłuż	v z d w u S
sądzenia	s oc5 dz e n i a
jedna	j e d n a
obić	o b i tsj
niteczek	n i t e tS e k
zwierciadełka	z v i e r tsj a d e w k a
brzegu	b Z e g u
zaś-	z a sj e
skarbem	s k a r b e m
mogiły	m o g i w i2
polskim	p o l s k i m
momentom	m o m e n t o m
flood	f l o o d
będą	b eo5 d oc5
skalę	s k a l e
przekrwioną	p S e k r v i o n oc5
wersji	v e r s j i
cierpienie	tsj e r p i e n i e
będzie	b eo5 dzj e
pietrowicz	p i e t r o v i tS
naturalnym	n a t u r a l n i2 m
czarującego	tS a r u j oc5 c e g o
powrocie	p o v r o tsj e
cegiełką	c e g i e w k oc5
odkrywa	o t k r i2 v a
oprzyj	o p S i2 j
przekazywania	p S e k a z i2 v a n i a
twej	t f e j
nierychło	n i e r i2 h w o
praktykom	p r a k t i2 k o m
nikczemność	n i k tS e m n o sj tsj
osobliwy	o s o b l j v i2
postawienia	p o s t a v i e n i a
priorytetów	p r j o r i2 t e t u v
instrumentu	i n s t r u m e n t u
tajemniczy	t a j e m n i tS i2
poczucia	p o tS u tsj a
gorączkowo	g o r oc5 tS k o v o
ważne	v a Z n e
zosię	z o sj i e
kopia	k o p i a
zniszczone	z n i S tS o n e
stanowi	s t a n o v i
główną	g w u v n oc5
zły	z w i2
syna	s i2 n a
maryjo	m a r i2 j o
zanosimy	z a n o sj i m i2
sprawy	s p r a v i2
obywatel	o b i2 v a t e l
statek	s t a t e k
pogrążony	p o g r oc5 Z o n i2
poznała	p o z n a w a
najdoskonalszej	n a j d o s k o n a l S e j
puścili	p u sj tsj i l j
puckiej	p u c k i e j
nieśmiałą	n i e sj m i a w oc5
maria	m a r j a
niepowodzenia	n i e p o v o dz e n i a
cesarza	c e s a Z a
otchłanie	o t h w a n i e
mówicie	m u v i tsj e
kryształów	k r i2 S t a w u v
odsyłają	o d s i2 w a j oc5
liczbę	l j tS b e
niewyrażalne	n i e v i2 r a Z a l n e
niefrasobliwość	n i e f r a s o b l j v o sj tsj
szwedzcy	S v e dz c i2
mudżahedinów	m u dZ a h e d j n u v
zazwyczaj	z a z v i2 tS a j
pagóry	p a g u r i2
zachowania	z a h o v a n i a
grafa	g r a f a
tadlock	t a d l o c k
najniższego	n a j n i Z S e g o
udział	u dzj a w
władania	v w a d a n i a
zmyślone	z m i2 sj l o n e
tak-	t a k
piwnicą	p i v n i c oc5
wierzchu	v i e Z h u
kluczowych	k l u tS o v i2 h
najzupełniej	n a j z u p e w n i e j
przysyłali	p S i2 s i2 w a l j
marszczy	m a r S tS i2
księżyca	k sj eo5 Z i2 c a
złowieszczego	z w o v i e S tS e g o
wszędzie	v S eo5 dzj e
żałuję	Z a w u j e
talentem	t a l e n t e m
północy	p u w n o c i2
plotynie	p l o t i2 n i e
bratem	b r a t e m
patrzeć	p a t S e tsj
illustrated	i l l u s t r a t e d
głębin	g w eo5 b i n
człowiecza	tS w o v i e tS a
ułożyły	u w o Z i2 w i2
intrygującą	i n t r i2 g u j oc5 c oc5
przyszły	p S i2 S w i2
pociech	p o tsj e h
prawdziwych	p r a v dzj i v i2 h
osób	o s u b
chcące	h c oc5 c e
wycięto	v i2 tsj eo5 t o
błędu	b w eo5 d u
port)-	p o r t e
że	Z e
ni	n i
porażonej	p o r a Z o n e j
kierujące	k i e r u j oc5 c e
niej	n i e j
ojcu	o j c u
usta	u s t a
najwyższym	n a j v i2 Z S i2 m
zdarzają	z d a Z a j oc5
pełną	p e w n oc5
rozbiegany	r o z b i e g a n i2
źródeł	zj r u d e w
sport	s p o r t
cień	tsj e n~
odpowiedzią	o d p o v i e dzj oc5
aspekty	a s p e k t i2
stanowiska-	s t a n o v i s k a e
dał	d a w
stanu	s t a n u
okute	o k u t e
unicestwienia	u n i c e s t f i e n i a
antyutopii	a n t i2 u t o p i i
wyprawa	v i2 p r a v a
rzecz	Z e tS
herman-	h e r m a n
wyzwanie	v i2 z v a n i e
słowo	s w o v o
napadnięty	n a p a d n i eo5 t i2
ciepły	tsj e p w i2
deluxe	d e l u k s e
145	s t o tS n tsj
obywatele	o b i2 v a t e l e
zakonu	z a k o n u
prosił	p r o sj i w
polemizuje	p o l e m i z u j e
unoszą	u n o S oc5
najważniejsze	n a j v a Z n i e j S e
buying	b u i2 i n g
kijowskie	k i j o v s k i e
wolnego	v o l n e g o
zespołu	z e s p o w u
największą	n a j v i eo5 k S oc5
wód	v u d
stajennymi	s t a j e n n i2 m i
wroga-brata	v r o g a b r a t a
ciszy	tsj i S i2
jakimiś	j a k i m i sj
kreon	k r e o n
rzeczy	Z e tS i2
warsztatów	v a r S t a t u v
położeniami	p o w o Z e n i a m i
rzeczywistości	Z e tS i2 v i s t o sj tsj i
gram	g r a m
biologii	b i o l o g i i
naiwnie	n a i v n i e
mają	m a j oc5
ojcowskiej	o j c o v s k i e j
powstrzymało	p o v s t S i2 m a w o
kieszonkowy	k i e S o n k o v i2
żadnych	Z a d n i2 h
ile	i l e
szuka	S u k a
kontrowersyjne	k o n t r o v e r s i2 j n e
bezsenną	b e z s e n n oc5
strony	s t r o n i2
ciężko	tsj eo5 Z k o
użyj	u Z i2 j
sprostać	s p r o s t a tsj
odznaczać	o dz n a tS a tsj
biuro	b i u r o
sytuacji-	s i2 t u a c j i e
sukces	s u k c e s
pomyślnie	p o m i2 sj l n i e
pokochał	p o k o h a w
chrystusa	h r i2 s t u s a
linii	l j n i i
przystojna	p S i2 s t o j n a
serdeczne	s e r d e tS n e
opowiadały	o p o v i a d a w i2
najcieńszą	n a j tsj e n~ S oc5
zdeptana	z d e p t a n a
członka	tS w o n k a
światłem	sj v i a t w e m
radością	r a d o sj tsj oc5
uzbroić	u z b r o i tsj
swobodnie	s v o b o d n i e
spodziewać	s p o dzj e v a tsj
osła	o s w a
ziemie	zj e m i e
pomoc	p o m o c
skorzystania	s k o Z i2 s t a n i a
śmiała	sj m i a w a
1986	v i eo5 t sj oc5 tsj e
rad	r a d
błagajmy	b w a g a j m i2
przychodniów	p S i2 h o d n i u v
objawia	o b j a v i a
drugie	d r u g i e
zachowują	z a h o v u j oc5
danym	d a n i2 m
spędzone	s p eo5 dz o n e
żelaznej	Z e l a z n e j
karaibów	k a r a i b u v
zaczepia	z a tS e p i a
wrócimy	v r u tsj i m i2
naszym	n a S i2 m
trup	t r u p
autorowi	a u t o r o v i
mocnego	m o c n e g o
towarzyszyły	t o v a Z i2 S i2 w i2
środki	sj r o t k i
wrzącego	v Z oc5 c e g o
adu	a d u
pałaców	p a w a c u v
wymagań	v i2 m a g a n~
v-	f e
świadków	sj v i a t k u v
postanawia	p o s t a n a v i a
spania	s p a n i a
wystarczyło	v i2 s t a r tS i2 w o
krążku	k r oc5 Z k u
każdej	k a Z d e j
objawiające	o b j a v i a j oc5 c e
uśmiechem	u sj m i e h e m
poziom	p o zj o m
uprawia	u p r a v i a
naczyń	n a tS i2 n~
rozbudzi	r o z b u dzj i
wygląda	v i2 g l oc5 d a
prawdziwy	p r a v dzj i v i2
kościoły	k o sj tsj o w i2
skłaniać	s k w a n i a tsj
dawnej	d a v n e j
odcineczki	o d tsj i n e tS k i
kukuruźnikiem	k u k u r u zj n i k i e m
prowincji	p r o v i n c j i
biedronka	b i e d r o n k a
najdrobniejszym	n a j d r o b n i e j S i2 m
gospodarzem	g o s p o d a Z e m
wszyscy	v S i2 s c i2
ciekawsza	tsj e k a v S a
przypominamy	p S i2 p o m i n a m i2
interesującą	i n t e r e s u j oc5 c oc5
pośpiesznie	p o sj p i e S n i e
oglądałem	o g l oc5 d a w e m
połowie	p o w o v i e
leksykony	l e k s i2 k o n i2
powikłany	p o v i k w a n i2
eucharystię	e u h a r i2 s t j e
powołany	p o v o w a n i2
pc	p c
sakramentalnymi	s a k r a m e n t a l n i2 m i
film	f i l m
eurydyki	e u r i2 d i2 k i
zaledwie	z a l e d v i e
paradoks	p a r a d o k s
ułożył	u w o Z i2 w
nieprzydatnym	n i e p S i2 d a t n i2 m
stosem	s t o s e m
przynajmniej	p S i2 n a j m n i e j
etapów	e t a p u v
jedynego	j e d i2 n e g o
zamków	z a m k u v
pełnia	p e w n i a
sa	s a
książek	k tsj oc5 Z e k
bezmyślnie	b e z m i2 sj l n i e
szpitala	S p i t a l a
skorupy	s k o r u p i2
chrześcijaństwa	h Z e sj tsj i j a n~ s t f a
uroczystości	u r o tS i2 s t o sj tsj i
zadowolić	z a d o v o l j tsj
nieee	n i e e e
niemieckiego	n i e m i e c k i e g o
kominami	k o m i n a m i
pokonać	p o k o n a tsj
uwielbiała	u v i e l b i a w a
wszechistnienia	v S e h i s t n i e n i a
zasługują	z a s w u g u j oc5
emulsji	e m u l s j i
wieszczbę	v i e S tS b e
piekle	p i e k l e
willi	v i l l j
pociesza	p o tsj e S a
ojcowie	o j c o v i e
formosusa	f o r m o s u s a
serce	s e r c e
panować	p a n o v a tsj
scenariusze	s c e n a r j u S e
posępne	p o s eo5 p n e
fundamentalnej	f u n d a m e n t a l n e j
wdzięku	v dzj eo5 k u
wieszczbiarzowi	v i e S tS b i a Z o v i
zamarli	z a m a r l j
rzymu	Z i2 m u
chełmiński	h e w m i n~ s k i
sentencje	s e n t e n c j e
brutalną	b r u t a l n oc5
mity	m i t i2
ludwik	l u d v i k
klęsk	k l eo5 s k
gq	g k
śmiesznie	sj m i e S n i e
opatruje	o p a t r u j e
barwiący	b a r v i oc5 c i2
pięknym	p i eo5 k n i2 m
czeczenii	tS e tS e n i i
nieposłuszny	n i e p o s w u S n i2
ottona	o t t o n a
pokutnik	p o k u t n i k
na	n a
uczenia	u tS e n i a
uczy	u tS i2
najsłabszego	n a j s w a b S e g o
obdarzyć	o b d a Z i2 tsj
kamerami	k a m e r a m i
narkotyki	n a r k o t i2 k i
suknem	s u k n e m
piękne	p i eo5 k n e
stopa	s t o p a
przesuwając	p S e s u v a j oc5 c
oraz	o r a z
wszechobecnych	v S e h o b e c n i2 h
przesądzony	p S e s oc5 dz o n i2
słów	s w u v
lewym	l e v i2 m
rota	r o t a
powder	p o v d e r
kijowie-	k i j o v i e e
zbliżają	z b l j Z a j oc5
polatam	p o l a t a m
czarek	tS a r e k
postępu	p o s t eo5 p u
obiecał	o b i e c a w
powtarzają	p o v t a Z a j oc5
hawajach	h a v a j a h
trafił	t r a f i w
długich	d w u g i h
wybiórczą	v i2 b i u r tS oc5
zdawkowo	z d a v k o v o
fali-	f a l j e
mieczem	m i e tS e m
nieprawdopodobnie	n i e p r a v d o p o d o b n i e
ponadto	p o n a d t o
oznaczenie	o z n a tS e n i e
badań	b a d a n~
szelestną	S e l e s t n oc5
owo	o v o
mężczyzna	m eo5 Z tS i2 z n a
kuleczki	k u l e tS k i
chciał	h tsj a w
ucha	u h a
przeprawach	p S e p r a v a h
czynną	tS i2 n n oc5
ogniska	o g n i s k a
odjąć	o d j oc5 tsj
zaproponował	z a p r o p o n o v a w
godziny	g o dzj i n i2
sprzed	s p S e d
skutki	s k u t k i
żyjątek	Z i2 j oc5 t e k
gotowych	g o t o v i2 h
wolę	v o l e
goldinga	g o l d j n g a
krzywulą	k S i2 v u l oc5
firm	f i r m
wątpliwa	v oc5 t p l j v a
palą	p a l oc5
wyrazu-	v i2 r a z u
należną	n a l e Z n oc5
żarnowieckie	Z a r n o v i e c k i e
przestaje	p S e s t a j e
aristajosa	a r j s t a j o s a
pereł	p e r e w
mikroskopijnego	m i k r o s k o p i j n e g o
arcydzieła	a r c i2 dzj e w a
backupy	b a c k u p i2
znów	z n u v
racji	r a c j i
obdarzonym	o b d a Z o n i2 m
płaszcz	p w a S tS
wybierają	v i2 b i e r a j oc5
rozłączył	r o z w oc5 tS i2 w
urlopie	u r l o p i e
ludwikowi	l u d v i k o v i
pomidorowej	p o m i d o r o v e j
wydumanego	v i2 d u m a n e g o
przepis	p S e p i s
żywym	Z i2 v i2 m
zaprosił	z a p r o sj i w
faceci	f a c e tsj i
archeologicznych	a r h e o l o g i tS n i2 h
jedni	j e d n i
samej	s a m e j
dopuszczał	d o p u S tS a w
józefie	j u z e f i e
sakramencie	s a k r a m e n tsj e
ogórków	o g u r k u v
georga	g e o r g a
donikąd	d o n i k oc5 d
dobre	d o b r e
mitologia	m i t o l o g i a
wszechstronnych	v S e h s t r o n n i2 h
dowcipem	d o v tsj i p e m
bezceremonialnie	b e z c e r e m o n i a l n i e
dobro	d o b r o
tworząc	t f o Z oc5 c
stojącej	s t o j oc5 c e j
nazwy	n a z v i2
niemu	n i e m u
kolorowy	k o l o r o v i2
dane	d a n e
skuteczność	s k u t e tS n o sj tsj
stage	s t a g e
wolne	v o l n e
stworzenia	s t f o Z e n i a
przez	p S e z
udanej	u d a n e j
zajrzeć	z a j Z e tsj
próbka	p r u b k a
upływem	u p w i2 v e m
elementarną	e l e m e n t a r n oc5
nogą	n o g oc5
nieżywych	n i e Z i2 v i2 h
umrzeć	u m Z e tsj
sopot	s o p o t
przeszywała	p S e S i2 v a w a
wyziera	v i2 zj e r a
kolorów-	k o l o r u v
przyszłego	p S i2 S w e g o
upodobnić	u p o d o b n i tsj
zawdzięczasz	z a v dzj eo5 tS a S
wyników	v i2 n i k u v
podziękować	p o dzj eo5 k o v a tsj
napadają	n a p a d a j oc5
prawdziwego	p r a v dzj i v e g o
zapadł	z a p a d w
dziedzictwa	dzj e dzj i c t f a
rysowałem	r i2 s o v a w e m
klepanie	k l e p a n i e
greckiej	g r e c k i e j
następstwem	n a s t eo5 p s t f e m
zgromadzi	z g r o m a dzj i
zwykłych	z v i2 k w i2 h
hierarchiczną	h j e r a r h j tS n oc5
znają	z n a j oc5
was	v a s
mógłbyś	m u g w b i2 sj
kośćmi	k o sj tsj m i
dobrym	d o b r i2 m
postawiłabym	p o s t a v i w a b i2 m
rytm	r i2 t m
serca	s e r c a
popełnił	p o p e w n i w
udziel	u dzj e l
zamykały	z a m i2 k a w i2
salazar-	s a l a z a r
magnes	m a g n e s
rajdach	r a j d a h
filmu	f i l m u
xix	k s i k s
decyzji	d e c i2 z j i
poziomie	p o zj o m i e
istnieniu	i s t n i e n i u
naraz	n a r a z
zewnątrz	z e v n oc5 t S
klasnął	k l a s n oc5 w
materiał	m a t e r j a w
grób	g r u b
fabułą	f a b u w oc5
czytać	tS i2 t a tsj
pożyczonych	p o Z i2 tS o n i2 h
zamilkła	z a m i l k w a
zastępy	z a s t eo5 p i2
kogoś	k o g o sj
schodzisz	s h o dzj i S
zarejestrowanej	z a r e j e s t r o v a n e j
tygodniach	t i2 g o d n i a h
kołysząc	k o w i2 S oc5 c
opatrznością	o p a t S n o sj tsj oc5
załóż	z a w u S
osobistej	o s o b i s t e j
nałogu	n a w o g u
jakimi	j a k i m i
puchatka	p u h a t k a
dążąc	d oc5 Z oc5 c
kazać	k a z a tsj
przejścia	p S e j sj tsj a
dłonią	d w o n i oc5
aktorzy	a k t o Z i2
międzymorza	m i eo5 dz i2 m o Z a
opętani	o p eo5 t a n i
należy	n a l e Z i2
kobrę	k o b r e
stają	s t a j oc5
dziadki	dzj a t k i
prywatne	p r i2 v a t n e
milczy	m i l tS i2
czyniłoby	tS i2 n i w o b i2
samemu	s a m e m u
straszne	s t r a S n e
krwiawię	k r v i a v i e
poznasz	p o z n a S
przebłagać	p S e b w a g a tsj
igły	i g w i2
religii	r e l j g i i
score	s c o r e
wieczorem	v i e tS o r e m
przynieść	p S i2 n i e sj tsj
wariantów	v a r j a n t u v
mógłbym	m u g w b i2 m
zobacz	z o b a tS
rozpoznawczym	r o z p o z n a v tS i2 m
lekkim	l e k k i m
pogładził	p o g w a dzj i w
te	t e
dostrzegamy	d o s t S e g a m i2
zupełnie	z u p e w n i e
niepokojącą	n i e p o k o j oc5 c oc5
powie	p o v i e
kolej	k o l e j
sięgają	sj eo5 g a j oc5
linie	l j n i e
trzeźwo	t S e zj v o
czas	tS a s
dnie	d n i e
rezultat	r e z u l t a t
duchu	d u h u
gdzie	g dzj e
wyuczony	v i2 u tS o n i2
spłowiałym	s p w o v i a w i2 m
tchem	t h e m
swojej	s v o j e j
czechy	tS e h i2
współpracownikami	v s p u w p r a c o v n i k a m i
szpiku	S p i k u
zależy	z a l e Z i2
ostatniego	o s t a t n i e g o
odmiany	o d m i a n i2
teologiem-	t e o l o g i e m e
służbowych	s w u Z b o v i2 h
rajdowi	r a j d o v i
grubopienne	g r u b o p i e n n e
skłonni	s k w o n n i
odratowaniu	o d r a t o v a n i u
zamierzał	z a m i e Z a w
sprzecznych	s p S e tS n i2 h
cały	c a w i2
zapiski	z a p i s k i
rys	r i2 s
przewodnikiem	p S e v o d n i k i e m
przeboje	p S e b o j e
planów	p l a n u v
połączenie	p o w oc5 tS e n i e
kuligi	k u l j g i
wyjaśnienie	v i2 j a sj n i e n i e
ramiona	r a m i o n a
miesiącu	m i e tsj oc5 c u
manier	m a n i e r
osiągnąć	o tsj oc5 g n oc5 tsj
kątem	k oc5 t e m
bought	b o u g h t
liz	l j z
moja	m o j a
mówiła	m u v i w a
sprzedającym	s p S e d a j oc5 c i2 m
złudzeniem	z w u dz e n i e m
przyborowski	p S i2 b o r o v s k i
kochaną	k o h a n oc5
ł	w
radzi	r a dzj i
piguły	p i g u w i2
tronu	t r o n u
myślę	m i2 sj l e
brał	b r a w
pańskim	p a n~ s k i m
late	l a t e
grobu	g r o b u
niósł	n i u s w
tam	t a m
ścieżkami	sj tsj e Z k a m i
suity	s u i t i2
ani	a n i
teorię	t e o r j e
planie	p l a n i e
ewangelię	e v a n g e l j e
przeżyła	p S e Z i2 w a
jaka	j a k a
brzmiące	b Z m i oc5 c e
kim	k i m
zasłonięty	z a s w o n i eo5 t i2
trzyma	t S i2 m a
zarabianie	z a r a b i a n i e
optyczna	o p t i2 tS n a
najlepsza	n a j l e p S a
internetowe	i n t e r n e t o v e
zbuduje	z b u d u j e
powinny	p o v i n n i2
zanadrzu	z a n a d Z u
rozwoju	r o z v o j u
mewy	m e v i2
starości	s t a r o sj tsj i
przeobraża	p S e o b r a Z a
bawarskiego	b a v a r s k i e g o
górę	g u r e
nowotna	n o v o t n a
cieniem	tsj e n i e m
powiedzieć	p o v i e dzj e tsj
lubię	l u b i e
polsce	p o l s c e
nasze	n a S e
odgrywać	o d g r i2 v a tsj
bałwochwalców	b a w v o h v a l c u v
skończyłam	s k o n~ tS i2 w a m
puścił	p u sj tsj i w
swoim	s v o i m
bin	b i n
powiek	p o v i e k
ś	sj
zbliżałeś	z b l j Z a w e sj
zasadę	z a s a d e
naturę	n a t u r e
dowierzałby	d o v i e Z a w b i2
pędy	p eo5 d i2
oficer	o f i c e r
spróbujmy	s p r u b u j m i2
dostęp	d o s t eo5 p
przybliżyć	p S i2 b l j Z i2 tsj
zagadka	z a g a t k a
czasach	tS a s a h
mniej	m n i e j
transformacją	t r a n s f o r m a c j oc5
śmiechem	sj m i e h e m
otoczenia	o t o tS e n i a
wieczornych	v i e tS o r n i2 h
tuż	t u S
alianci	a l j a n tsj i
takim	t a k i m
najchętniej	n a j h eo5 t n i e j
obłokami	o b w o k a m i
byłam	b i2 w a m
e	e
burzyki	b u Z i2 k i
łaby	w a b i2
strzelby	s t S e l b i2
sesjach	s e s j a h
coraz	c o r a z
nieporozumieniem	n i e p o r o z u m i e n i e m
oblec	o b l e c
marzeń	m a Z e n~
przyźby	p S i2 zj b i2
sioła	sj o w a
testament	t e s t a m e n t
tajemnie	t a j e m n i e
przeskakiwać	p S e s k a k i v a tsj
arkuszem	a r k u S e m
wstrzemięźliwości	v s t S e m i eo5 zj l j v o sj tsj i
słabszym	s w a b S i2 m
szczęścia	S tS eo5 sj tsj a
wejścia	v e j sj tsj a
zdrowia	z d r o v i a
zmysły	z m i2 s w i2
masa	m a s a
królewskiej	k r u l e v s k i e j
pośladkami	p o sj l a t k a m i
claire	c l a i r e
kanon	k a n o n
swobody-	s v o b o d i2
techniki	t e h n i k i
kazał	k a z a w
siania	tsj a n i a
towarzystwie	t o v a Z i2 s t f i e
wydarł	v i2 d a r w
ojcowe	o j c o v e
przedmiot	p S e d m i o t
jest-	j e s t
udawało	u d a v a w o
zostanie	z o s t a n i e
80	sj oc5 t
sophią	s o p h j oc5
również	r u v n i e S
strażą	s t r a Z oc5
tłumaczyłam	t w u m a tS i2 w a m
człowiek	tS w o v i e k
słuchał	s w u h a w
wieszczbiarz	v i e S tS b i a S
przykazania	p S i2 k a z a n i a
irracjonalne	i r r a c j o n a l n e
zdrowe	z d r o v e
jezioro	j e zj o r o
trudno	t r u d n o
reżyserii	r e Z i2 s e r j i
ból	b u l
dorośnie	d o r o sj n i e
powoli	p o v o l j
politycy	p o l j t i2 c i2
stopień	s t o p i e n~
śmy	sj m i2
koronek	k o r o n e k
wzniosłych	v z n i o s w i2 h
bramę	b r a m e
sushi	s u s h j
świeczki	sj v i e tS k i
młodzież	m w o dzj e S
pomocą	p o m o c oc5
aby	a b i2
jonathan	j o n a t h a n
relacją	r e l a c j oc5
hałaśliwych	h a w a sj l j v i2 h
portu	p o r t u
zapłakać-	z a p w a k a tsj e
stylów	s t i2 l u v
usuń	u s u n~
zabić	z a b i tsj
macho	m a h o
rzeką	Z e k oc5
stwierdził	s t f i e r dzj i w
pochodzą	p o h o dz oc5
szlify	S l j f i2
doznań	d o z n a n~
dwie	d v i e
prawą	p r a v oc5
sytuacji	s i2 t u a c j i
słyszymy	s w i2 S i2 m i2
czasami	tS a s a m i
trafiają	t r a f i a j oc5
muzyki	m u z i2 k i
agnieszko	a g n i e S k o
światu	sj v i a t u
niestety	n i e s t e t i2
zwierzątko	z v i e Z oc5 t k o
czekała	tS e k a w a
trakcie	t r a k tsj e
radość	r a d o sj tsj
jakie	j a k i e
cieszą	tsj e S oc5
masz	m a S
rybitwy	r i2 b i t f i2
wybaczamy	v i2 b a tS a m i2
muzyckie	m u z i2 c k i e
pewnych	p e v n i2 h
służący	s w u Z oc5 c i2
trudny	t r u d n i2
bryk	b r i2 k
mówiło	m u v i w o
rozszerzonych	r o z S e Z o n i2 h
aimee	a j m e e
kup	k u p
wiekuiście	v i e k u i sj tsj e
którego	k t u r e g o
doczekać	d o tS e k a tsj
ujrzeli	u j Z e l j
najlepszych	n a j l e p S i2 h
konstrukcją	k o n s t r u k c j oc5
być	b i2 tsj
patrz	p a t S
jedyny	j e d i2 n i2
udami	u d a m i
powiem	p o v i e m
zgodzić	z g o dzj i tsj
nieodwzajemnionej	n i e o d v z a j e m n i o n e j
całe	c a w e
wpływowi	v p w i2 v o v i
kaczki	k a tS k i
nagroda	n a g r o d a
ekstrawaganckim	e k s t r a v a g a n c k i m
składamy	s k w a d a m i2
kalin	k a l j n
żonę	Z o n e
władcą	v w a d c oc5
walkę	v a l k e
lwa	l v a
komplement	k o m p l e m e n t
czym	tS i2 m
konstrukcji	k o n s t r u k c j i
towarzystwie-	t o v a Z i2 s t f i e e
dużym	d u Z i2 m
ośmiu	o sj m i u
stworzenie	s t f o Z e n i e
pokryła	p o k r i2 w a
samochodów	s a m o h o d u v
caryca	c a r i2 c a
fabuła	f a b u w a
przebaczenia	p S e b a tS e n i a
drewienka	d r e v i e n k a
urządza	u Z oc5 dz a
komedię	k o m e d j e
szymonem	S i2 m o n e m
podłóg	p o d w u g
zacytowane	z a c i2 t o v a n e
twój	t f u j
wspólnocie	v s p u l n o tsj e
spojrzał	s p o j Z a w
cal-	c a l
niebieskiej	n i e b i e s k i e j
wyrzucą	v i2 Z u c oc5
przebiega	p S e b i e g a
morze	m o Z e
biskupom	b i s k u p o m
facet:-	f a c e t e
jako	j a k o
solidnie	s o l j d n i e
anglii	a n g l j i
przygotowując	p S i2 g o t o v u j oc5 c
utworzymy	u t f o Z i2 m i2
kolejny	k o l e j n i2
saskiego	s a s k i e g o
dobrze	d o b Z e
zbite	z b i t e
szanują	S a n u j oc5
poświęciła	p o sj v i eo5 tsj i w a
piec	p i e c
kiereję	k i e r e j e
kwietniu	k f i e t n i u
zblednąć	z b l e d n oc5 tsj
żywotność	Z i2 v o t n o sj tsj
donosy	d o n o s i2
poszło	p o S w o
portretowany	p o r t r e t o v a n i2
napisałem	n a p i s a w e m
ukrywać	u k r i2 v a tsj
podobny	p o d o b n i2
włosów	v w o s u v
różnych	r u Z n i2 h
faktyczny	f a k t i2 tS n i2
obawiasz	o b a v i a S
zachodnim	z a h o d n i m
lekko	l e k k o
raptem	r a p t e m
witają	v i t a j oc5
swiętopełk	s v i eo5 t o p e w k
młodym	m w o d i2 m
wytępienia	v i2 t eo5 p i e n i a
odnośnika	o d n o sj n i k a
instytucją	i n s t i2 t u c j oc5
lekarz	l e k a S
mknie	m k n i e
powieści	p o v i e sj tsj i
odtworzył	o d t f o Z i2 w
samotne	s a m o t n e
odczuwasz	o d tS u v a S
kilku	k i l k u
oglądać	o g l oc5 d a tsj
nieszkodliwe	n i e S k o d l j v e
pójdę	p u j d e
zatoki	z a t o k i
scenografom	s c e n o g r a f o m
okoliczności	o k o l j tS n o sj tsj i
groteską	g r o t e s k oc5
zmienić	z m i e n i tsj
zestarzałe	z e s t a Z a w e
strącał	s t r oc5 c a w
nieszczery	n i e S tS e r i2
młodszy	m w o d S i2
skusić	s k u sj i tsj
dzieciństwie	dzj e tsj i n~ s t f i e
miejskie	m i e j s k i e
programu	p r o g r a m u
kiedy	k i e d i2
obyczajowych	o b i2 tS a j o v i2 h
byś	b i2 sj
24-bitowy	d tS t b i t o v i2
materialnych	m a t e r j a l n i2 h
zagłady	z a g w a d i2
eksperyment	e k s p e r i2 m e n t
największym	n a j v i eo5 k S i2 m
zgadując	z g a d u j oc5 c
manifestują	m a n i f e s t u j oc5
pokoju	p o k o j u
krok	k r o k
okazji	o k a z j i
szyków	S i2 k u v
ramienia	r a m i e n i a
odwodzie	o d v o dzj e
słowiańskie	s w o v i a n~ s k i e
ustalonych	u s t a l o n i2 h
fizyczna	f i z i2 tS n a
odkładam	o t k w a d a m
jelenie	j e l e n i e
zapraszają	z a p r a S a j oc5
neapol	n e a p o l
postacią	p o s t a tsj oc5
arkusz	a r k u S
misterny	m i s t e r n i2
niewolę	n i e v o l e
własną	v w a s n oc5
najgroźniejszego	n a j g r o zj n i e j S e g o
terrorysty	t e r r o r i2 s t i2
trzecie	t S e tsj e
odwracała	o d v r a c a w a
tygodnie	t i2 g o d n i e
perkozy-	p e r k o z i2
piętrowym	p i eo5 t r o v i2 m
słychać	s w i2 h a tsj
wielki	v i e l k i
przesunął	p S e s u n oc5 w
westchnienia	v e s t h n i e n i a
materialny	m a t e r j a l n i2
gwiazd	g v i a z d
starodawne	s t a r o d a v n e
jedynaczki	j e d i2 n a tS k i
natomiast	n a t o m i a s t
itp	i t p
odkrył	o t k r i2 w
błota	b w o t a
rozdeptać	r o z d e p t a tsj
zmierza	z m i e Z a
samo	s a m o
dvd	d f d
trochę	t r o h e
hitlera	h j t l e r a
żyjący	Z i2 j oc5 c i2
opizzoni	o p i z z o n i
fascynacje	f a s c i2 n a c j e
grube	g r u b e
efektem	e f e k t e m
męką	m eo5 k oc5
miłością	m i w o sj tsj oc5
myślą	m i2 sj l oc5
mobilizują	m o b i l j z u j oc5
reliefu	r e l j e f u
istotne	i s t o t n e
wypróbowanego	v i2 p r u b o v a n e g o
prywatnych	p r i2 v a t n i2 h
okazując	o k a z u j oc5 c
wspomina	v s p o m i n a
perspektywę	p e r s p e k t i2 v e
plecach	p l e c a h
płaczu	p w a tS u
10	s t o
biblioteki	b i b l j o t e k i
ucierpiałaby	u tsj e r p i a w a b i2
ścianę	sj tsj a n e
wyraz	v i2 r a z
wielkich	v i e l k i h
prawej	p r a v e j
zamyślił	z a m i2 sj l j w
zmusza	z m u S a
piasku	p i a s k u
oznajmia	o z n a j m i a
podstawy	p o d s t a v i2
śmieszną	sj m i e S n oc5
ściągał	sj tsj oc5 g a w
m.in	m i n
stalowej	s t a l o v e j
nadziei	n a dzj e i
bycia	b i2 tsj a
młodzieży	m w o dzj e Z i2
obalił	o b a l j w
pasji	p a s j i
podobnymi	p o d o b n i2 m i
ociąga	o tsj oc5 g a
stwierdzam	s t f i e r dz a m
godzin	g o dzj i n
odpowiedź	o d p o v i e dzj
checzy	h e tS i2
dużej	d u Z e j
lubisz	l u b i S
łosich	w o sj i h
